
-------------------- A--------------------

aback - pödio
abacus - bakud
ace - truf
ability - fäg
able; to be able to - kanön
ably - fägiko
abnormal - nenomik
aboard (ship) - in boid
about - za, zao
    * about ten times = za degna
    * glad about s.th. = fredik dö bos
above - löpo, lopü, sus
    * above all = mu pato
abroad - (location) foginäno, in foginän
  - (direction) foginänio, ini foginän
absent - nekomik
absolute - verik
(to) absorb - nüsugön
abstract - nedabinotik, nesiädik
(to) abuse - lunofön
acacia - kaaziad
accelerator (pedal) - vapatridöm
accent - pükasotül
(to) accept - dasumön, getedön
accessible - lügolovik
accident - (chance event) = fäd
  - (mishap) = mijenot
(to) accompany - dugädön; (music: dugedön)
accomplice (in crime) - kedöban
according to - bai; ma
account - (bill) = kalot
  - (report) = nunod; nunodön (tefü)
  - (justification) = gidükam; gidükön
  - (be responsible) = gididön; gididikön
    * I will account for it = ogididikob tefü atos
accountant - bukädanolavan
accusation - kusad
(to) accuse - kusadön
accused - kusadäb
accuser - kusadan
(to) accustom - kösömükön
accustomed - kösömik
    * to get accustomed to = kösömikön (ad)
ache - duladol; dol dulik
acid(ic) - züdöfik
(to) acknowledge - dasevön
acknowledgement - dasev
(to) acquaint - nunön; sevädükön
acquaintance - seväd; sevädan
(to) acquire - dagetön
acquirement - dagetot
acquisition - daget; dagetot
acre (of land) - göded
across - travärü
act - (theatrical) = süf
(to) act - dunön; magulön
    * to play `Shylock' = magulön eli `Shylock'
action - dunot
actor - dramatan, hidramatan
actress - jidramatan
actual - jenöfik
actually - jenöfo
(to) adapt - lönedükön
(to) add - (maths) = kobonumön; saedön
  - (add to something else) = lüükön
address - ladet
addressee - ladetäb
adept - däpäb
adjective - ladyek
(to) adjust - lönedön
(to) administer - guvön
admirable - stunidabik
(to) admire - stunidön
(to) admit - letön
    * to admit something = siön bosi
(to) adopt - daoptön
    * an adopted child = hi/jidaoptäb
    * an adoptive parent = hi/jidaoptan
adorable - leplekabik
adoration - leplekam
(to) adore - leplekön
adorer - leplekan
adult - daülan
advance - (further) = föd; födön
  - (progress) = proged; progedön
  - (promote) = fopladam; fopladön
advantage - frut, buäd
adventure - ventür
adventurer - ventüran
adventurous - künik; ventürik
adverb - ladvärb
advert (TV commercial) - televidanunam
(to) advertise - notedön
advertisement - noted, nunam
advice - (counsel) = konsäl
(to) advise - konsälön
aerial - (radio) = lanten
    * an aerial view = selogam lutik
aeroplane - flitöm
affair - din
affliction - dränäl
(to) afford - fägön ad pelön/remön
    * I can't afford it = no fägob ad remön ati / no labob moni ad pelön osi
afloat - flotik
afraid - dredik
(to be) afraid (of) - dredön (demü, pro, tefü)
after - po, pos
afternoon - poszedel
    * this afternoon = aposzedelo
    * yesterday aft = äposzedelo
afterwards - latikumo, poso
again - dönu
against - to, kol
age - bäld, bäldot
(to) age - bäldikön
agglutinative - kobioklebik
ago - bü ...
(to) agree - baicedön (ko); baivögön; baiädön
agreeable - plitik
ah! - ag! o!
aha! - yöbö!
ahead - föfio; föfo; büiko
aid - yuf; yufön
aim - zeil; zeilön
  - disein; diseinön
aimless - nendiseinik
air - lut
    * air hostess = flitajidaifidan
    * airtight = härmetik
alarm - laram; laramön
    * alarm-clock = galükian
alchemist - lalkiman
alcove - bef
alder (tree) - lanud
(to) alight (from) - sexänön (de, se)
alive - lifik
all - valik
alliteration - tonatükam
(to) allow - dälön
alloy - laliad
all-round - valaskilik
allusion - mäniotül
almighty - valanämädik
almost - tio
aloe (plant) - laoäd
alone - soalik, soelik
along - ve
aloud - laodiko
already - ya
also - i, id
(to) alter - votükön
alto (music) - lalt
although - do
always - ai
(to) amaze - stunükön
ambiguous - telplänovik
ambition - dasteif, stimiäl
ambitious - dasteifik, labiälik, stimiälik
ambulance - malädanivabed
among - bevü
amount - (price) = suäm
(to) amount to - suämön
(to) amuse - muadön
amusement - muad
amusing - muadik
anaesthetic - stordit
ancient - vönik
anchor - nak; nakön (len)
anchovy - najov
and - e, ed (before vowel)
anecdote - konotül
anemone - naemun
angel - silanan
angelic - silananik
anger - zun, skan
angle - gul
angry - zunik, skänik
animal - nim
anisette (liqueur) - naidalikör
ankle - futayoin
    * to sprain one's ankle = viodön futayoini oka
(to) announce - nunön
announcement - dalebüd, noted, nun, nunam
(to) annoy - böladön, skänön, tupön
annoyance - bölad, skän, tup
annual - alyelik
answer - gesag; gespik
(to) answer - gesagön, gespikön
ant - furmid
antarctic - sulüdapovik
antenna - lanten
(to) anticipate - spetidön
antique(s) - vönot(s)
antiquity - vön
antler - tuigahon
anvil - naklüm
anxious - dredälik, kudik
any - seimik
anybody - ek; seiman
anywhere - seino
apart (from) - flanü
(to) apologize - gidükön oki; begön säkusadi
apology - säkusad; okgidükam
apparatus - parat
apparently - jiniko
appeal - (appeal to) = lapel
  - (attraction) = tirädanäm
(to) appeal (to) - lapelön (lü); yufidön
appealing (charming) - löfidik
(to) appear - (person) = dajonön oki
  - (to seem) = jinön
  - (in general) = pubön
appearance - jin, pub
appendicitis - kekunaflamat
appetite - pötit
apple - pod
(to) applaud - lobülön, plodön
appliance - läneodot
applicable - pötöfik
application - (for work) = lisit
(to) apply for - lisitön
    * to apply for a job = lisitön cali
(to) appoint (s.o.) - cälön (eki)
appointment - cäl, cälod
(to) appreciate - digidön
appreciation - digid
(to) approach - nilikön (lü)
approval - lobül
    * on approval = logamio
apricot - brikod
April - prilul
apron - jeled
Arab - Laraban
arabesque (music) - larabot
arable (land) - feilaläned
arbour - priel
arch (of building) - bobäd
archery - caram
archive - ragiv
arctic - nolüdapovik
ardent - glutik
arena - komipöp, mätöp
(to) argue (about) - blöfön
  - döbatön (dö)
    * to win over = slüdön eki ad
argument - blöfastab; döbat, vödafeit
(to) arise - (metaphorically) = davedön
  - (in fact) = löpikön
arisen - edavedöl; elöpiköl
arm - (limb) = brad
  - (weapon) = vaf; vafön
armchair - bradastul, stutömastul
    * an armrest (on chair) = bradastutöm
army - milit
around - züo
aroused (emotions) - fäkädiko
(to) arrange - leodükön, lonön
arrival - lüköm
(to) arrive - lükömön (lü)
    * a new arrival = lüköman
(to) arrest - fanäbükön
arrow - sagit
art - lekan
artery - ratär
artful - skilöfik
artichoke - tijod
article - (object) = yeg, din
  - (newspaper) = lartüg, yeged
  - (part of speech) = lartig
artificial - mekavik
as - (preposition) = as, äs
  - (conjunction) = asä, äsä, bi
  - (as it were) = äsvo
    * as soon as = sosus
ash - zen
    * ashtray = zeniär
ashamed - jemik
(to be) ashamed (of) - jemön (demü, tefü)
(to) ask - (favour) = begön
  - (question) = säkön
asparagus - sparag
aspiration - dasteif, ledesir
assembly - kolkömanef
assertion - lesag
(to) assist - yufön
    * to ask for assistance = yufidön
assistance - dünot, yuf
assistant - dünotan, yufan
(to) associate (with) - kosädön (ko)
(to) assume - (take over) = dasumön, lovesumön
  - (arrogate) = rogön
  - (suppose) = büocedön
assumption - dasum; lovesum, büoced
(to) assure - (verbally) = lesiön
  - (against risk) = surön
assurance - lesiam, sur
(to) astonish - stunükön
astonished - stunik
astonishment - stun
astronaut - sinafan
asylum - lasil
at - tö; in; len, pö; ün
atmosphere - lutem
atoll - korialanisul klöpik
(to) attribute - givülön
(to) attach - fimükön
attachment - fimükam
attack - tatak; tatakön
attempt - (plot) = tram
  - (strive) = steifül
(to) attempt - betramön (eki)
  - (plot against) = tramön (bosi eke)
  - (to strive) = steifülön
(to) attend - dugädön; komön (in)
  - küpälön (ad)
    * to attend to (in a café) = botön
    * to listen carefully = dalilön
attendance - dugäd, kom, küpäl
attendant - dugädan, kälädan
attention - käläd, küpäl
    * pay attention! = prüdö!
    * to draw attention to = küpälükön
attentive - blümik, kälädik, küpälik, prüdik
attentiveness - blümäl
attic - masad
attitude - jästäd
(to) attract - jänälön, tirädön
attraction - tirädanäm
audience - lüloganef
August - gustul
aunt - jiter, zian
author - lautan
authoritative - nämätik
autority - nämät
(to) authorize - dälädön
autobiography - italifajenäd
autonomy - itreig
automatic - itjäfidik
automation - itjäfidavam, itjäfidükam
autumn - fluküp
(to) avail - frutön
available - gebidik
    * to be available = gebidön
    * to have available = gebidön (dö)
    * to make s.th. available to s.o. = gebidükön eke bosi
avaricious - lavarik
(to) avenge - vinditön
avenue - lael
average - zäned, zänedöfik
    * on average = zänedo
    * an average person = komunan
(to) avoid - büovitön, vitön
awake - galik
    * to be awake (watchful) = galikön
aware - spetöfik
    * to be aware = spetöfön (dö)
away - mo
awe - dalestüm
awful - dredabik, jeikik
    * full of awe = dalestümabik
awkward - neskilik, grobälik
axe - cüd, lecüd
axiom - xiom
azalea (bush) - zaär

-------------------- B--------------------

baby - cilil, käläb, putül, sügäb
bacillus - bazil
back - bäk
back (= rear) - pöd
backwards - pödio
    * backwards and forwards = pödio e föfio
bacon - pined
bacteriology - bakterav
bacterium - bakter
bad - badik
badger - daf
bag - sakäd, saked
    * a paper bag = düd
bait - bätazib
(to) bake - bakön
baker - bakan
bakery - baköp
balance - leigavet, vätöm
balcony - bakun
bald - jofik
ball - (dance) = baol
  - (sphere) = glöp
  - (bounce ball) = tajedapled
  - (game) = glöpäd
balsam - balsamin
balustrade - boidastutöm
bamboo - bambud
band - (musicians) = musiganef
  - (binding) = tan, tanod
  - (troupe) = trup
bandage - flabülod
    * to bandage up = flabülön
(to) banish - xilön
banishment - xil
banjo - bänyun
bank - (finance) = bank
  - (of river) = jol
barber - jeifan
barber shop - jeiföp
bare - nüdik; nüdükön
barefoot - nüdafutik
bareheaded - nüdakapik
(to) bargain - bligidön remi/tedoti
    * a bargain = rem frutik
bark - (of dog) = vaul, vaulam
  - (on tree) = jal
(to) bark - vaulön
barley - hod
barn - barak
bark (on tree) - jal
barracks - (military) = kaser
barricade - barikad
base - (inferior) = bapälik
  - (bottom) = stab;
  - (to base) = stabön
basement - distead
basics (guidelines) - stabaliens
basin - bov
basket - bäset
basketball - (game) = bäsetaglöpäd
bat - (creature) = flitamug
bath - ban, banöp
    * to take a bath = banön
    * to bathe outside = banön natädo
bathroom - banacem
bathtub - banatüb
battery - kumulator (= for car); ziöbedemil (= small)
battle - lekomip; lekomipön (ta)
battlefield - lekomipöp
battleship - bländanaf, lekomipanaf
bay - (inlet) = bug
(to) be - binön
beach - jol, sabajol
beak - honed (= on bird)
bean - bon
(to) bear - polön
bear - (animal) = ber
beard - balib
bearded - balibilabik
beast - nim, lunim
beastly - nimälik
(to) beat - flapön
beautiful - jönik
beauty - jön
because - bi, ibä
(to) become - vedön
bed - bed
    * to go to bed = golön lü bed
    * a flower bed = bet
bedlinen - bedastofeds
bedroom - slipacem
bee - bien
beech (tree) - bueg
beef - bubamit
beer - bir
beetle - cäf
before - (conjunction) = büä
  - (preposition) = bü, fo
  - (adverb) = büo
(to) beg (s.th. from s.o.) - begön (eke bosi)
(to) begin (to) - primön (ad)
beginning - prim
begonia - begun
(to) behave - kondötön
behaviour - bitikam, kondöt
behind - (of place) = po
  - (of time) = pos
beige - bäjunik
being - jafäb
    * for the time being = büfo
belief - lekred
(to) believe - kredön
(to make) believe - kredidön
bell - klok, klokil, klokül (=door)
belly - bälid
(to) belong (to) - (le)dutön (lü)
below - dono
belt - (clothing) = zönül
    * Green Belt = zönöp grünik
bend - blegod
    * a bend in the road = vegablegod
(to) bend - blegükön, flegön
benefactor - benodan
benefit - frut
(to) benefit - benükön, frutön
bent - (curved) = blegik
berry - bäl
beside(s) - näi, plä
bestial - nimälik
bet - yül; yülön
better - gudikum, gudikumo
between - bevü, vü
beverage - drined
beyond - etflano, etflanü, loveflanü
bible - bib
bicycle - saikul
(to) bid - (command) = büdön
  - (offer) = lofön
bidder - lofan
birch (tree) - biad
big - gretik
(to) bike - saikulön
bikini - niblitül
bilberry - vaxen
bill - (invoice) = kalot
  - (parliamentary) = lonidisin
  - (bank draft) = tret
(to) bind - tanön, tanädön (= books)
    * to bind up = flabülön
bird - böd
birth - moted
biscuit - biskut
bit - bosil; gimil (= electric drill)
bite - beit, beitil; beitön
bitter - (taste) = biedik
  - (emotion) = biedälik
bittern (bird) - botur
bitterness - biet, biedäl
black - blägik
blackbird - merul
blacksmith - grobasmitan
bladder - (anatomy) = vesid
blame - blam; blamön
blameless - neblamabik
blanket - teged
(to) bleed - bludön
    * to bleed s.o. = blüdön eki
blender - (kitchen) = migöm
(to) bless - benedön, lelobön
blessed - läbik, beatik
blessing - bened
blind - (unseeing) = bleinik
  - (roller) = rulakörten
    * blind man's buff = bleinanipled
blindness - blein
block - blög
blockade - blok; blokön
blood - blud
    * blood pressure = bludapedot
    * a blood vessel = fesül
(to) blossom - florön
blot - sten
    * blotting-paper = nüsugapapür
blouse - yäk
blow - (hit) = flap
  - (tragedy) = damifät
(to) blow - (thro' mouth) = bladön
  - (wind) = lebladön
(to) blow up - spranön
blue - blövik
blunt - (not sharp) = nejapik
board - (wood) = boed
  - (ship) = boid
  - (food) = bord
  - (packaging) = karton
    * to board ship = boidön oki
    * boarding house = bordöp
boast - pleidäl; pleidülön (dö/tefü)
boat - bot
    * a rowing-boat = gubabotil)
body - (physique) = koap
  - (general) = kop
Bohemian - Bömänik
  - (organization) = klubäd
(to) boil - kukön
    * a boild egg = kükanög
    * to boil water = kükön vati
    * boiling hot = lehitik)
bold - boldik, künik
bone - bom
bonnet (of car) - kapüt
book - buk
    * bookseller = bukiselan
    * bookshop = bukiselöp
    * bookcase = bukaramar
(to) book - bonedön
booking office - bilietabür
boot - but
border - (brim) = sim
  - (hem) = siem
(to) bore - (drill) = gimön
  - (tire) = naütön
born - pemotöl
(to be) born - pamotön
(to) borrow (from) - loenön (de)
both - bofik
bother - tom; tomön
(to) bother (about) - jäfikön (me)
bothersome - böladik, tupik
bottle - flad
bottom - (not top) = don
  - (of sea) = lestab
  - (of barrel) = stabül
bound for - vegamü
boundary - mied
boundless - nenmiedik
bow - (anything curved) = bob
  - (for shooting arrows) = car
  - (an act of reverence) = bieg
    * to bend low before = biegön lo
    * to bend wire = blegükön drati
box - (large) = bog
  - (general) = bok
  - (small) = büg
  - (case) = kasät
(to) box - (sport) = boxön (ta)
boy - pul, hipul
bracers - blitipolians
braggart - pleidaspikülan
brain - brein
brake - frenöm; frenön
    * a footbrake = futafrenöm
    * a handbrake = namafrenöm
branch - tuig
brandy - konyak
brass - läten
brassière - dögipolian
brave - kuradik
bread - bod
    * a bread roll = bodedül
    * breadfruit = bodepafrut
(to) break - breikön
    * breaking the law = lonaneföl
breakfast - janed; janedön
breast - blöt
breath - natem
(to) breathe - natemön
breathless - nennatemik
breed - (race) = bidäd
  - (breed) = bridot
  - (hatch) = kuvot
(to) breed - bridön
    * to hatch eggs = kuvön nögis
(to) bribe - remädön
brick - bakasten
bricklayer - masonan
bride - jigam
bridegroom - higam
bridge - pon
brief - brefik
bright - litik, kleilik
  - (bright, light, sound) = nedumik
brilliant - nidik (= shining); legudik (= very talented)
  - (a cut diamond) = nidain
(to) bring - blinön
    * to bring up children = loseidön
brisk - liföfik
broad - (spacious) = veitik
  - (wide) = vidik
broadcast - broad, sesed
(to) broadcast - broadön, sesedön
brocade - brokat
bronze - bronsöt
broom - svip
brocade - brokat
brothel - lupanar
brother - brod, higem
brown - braunik
(to) brouse (through) - padön (in)
brush - kef; kefön
Brussels sprout - sprotianabrasid
bubble - bulil
bubbly - bulik
bucket - böket
buckle - snab
bud - gnob
    * flower bud = floragnob
Buddhist - Budan
budgerigar - vefapapagil
(to) build - bumön
bulb - (plant) = läf
  - (electric) = glutapir
bull - tor
bunch of grapes - vitidabälem
burdensome - böladik
burial - sepülam
(to) burn - (general) = filön
  - (conflagration) = lefilön
  - (to ignite) = filidön
  - (to consume) = filedön
  - (to cause to burn) = filükön
    * to burn coal = filedön boadakolati
    * to burn incense = filükön boväli
(to) burst - kräkön
(to) bury - sepülön
bus - (motora)nibud
bush - fotil, bimül
bushy - fotülagik
business - büsid, tedot
businessman - büsidan, tedan
    * to do business = tedön
busy - jäfädik
    * I am extremely busy = binob jäfädikün
(to be) busy (with) - bejäfön, jäfön (me)
    * to busy oneself with = jäfükön oki me ...
but - ab
butcher - miticöpan
    * butcher's shop = miticöpöp
butter - bör
butterfly - pab
button - knop; knopön
buy - remön
by - (person) = fa
  - (position) = lä
(to) buzz - brumön

-------------------- C--------------------

cabala (teaching) - kabaal
cabbage - brasid
cabin - kayüt, käben
cabinet (bedside) - neitaramaril
cactus - kaktud
cafeteria - kafetar
cage - cek
cake - kek
(to) calculate - kalkulön
calculator - numian
calf - bubül
calibre (bore) - kalib
(to) call - vokön
    * to call quits = klirikön
(to be) called - panemön
calm - stilik, takedik
(to) calve - bubülimotön
camel - jamod
camera - käm
    * a surgical camera = dalukäm
camp - leseatöp
can (tin) - tünabok
canal - kanäd
canary - kanair
(to) cancel - nosükön
candidate - steifädan
candle - kandel
candle-light - kandelalit
candle-stick - kandelikipian
canoe - kanud
    * outrigger canoe = kanud kostütömik
cap - (for head) = luhät
  - (for bottle) = kapsül
capability - skil
capable - fägik, skilik
cape - (geographical) = kep
capital - (of country) = cifazif
  - (money) = katäd
    * working capital = febakatäd
capitalism - katädim
(to) capitulate - klemedön
capsule (pill) - kapsul
captain - (army) = kapiten
  - (ship) = käpten
caravan (= travelling group) - karov
car - motoravab, tood
carab (tree) - zerat
carat (gold) - kirat
carburettor - vapüköm
card - kad
care - (caring for) = käl
  - (anxiety) = kud
careful - kälöfik
(to) caress - löfülön
(to) caricaturize - mimagodön
cargo - lodot
carnation - kariof
carp - (fish) = karip
carpet - tapäd
carriage - vab
carrot - dauk
carrousel - karusäl
(to) carry - polön
cart - luvab
cartography - kaedav
cartoon - däsinot
  - (animated film) = däsinotabioskop
(to) carve - nücidön
case - (chest) = bog
  - (box-container) = bokod, bokül, kasät
  - (an event) = jenet
  - (suitcase) = trök
  - (étui) = vead
    * a law case = gitädasäkäd
cash - käd
    * a cash desk = kädöp
cashmere (wool) - kajmir
cassette - (tape) = kasät
  - (audio) = tonakasät
  - (video) = magodakasät
(to) cast - (molten metal) = gifön
  - (throw) = jedön
castanet - krotöm
castle - kased
cat - kat, jikat
cataract - star gedik
catarrh - snöf
(to) catch - fanön
category - rood
caterpillar - jönul
cathedral - leglüg
cattle - veter
cauliflower - florabrasid
case - kod; kodön, koedön
caution - prüd
cautious - prüdik
cave - kev
cavern - lekev
cavity - kevil
(to) cease - stopön, finükön, stöpön
ceaseless - nenropik
ceiling - nufed
(to) celebrate - zelön, yubidön
celebration - lezälizel
celery - sälärid
cell (in body) - siül
cellar - kav
celtic - kältik
cement - zäm
censorship - sänsur
cemetery - deadanöp
central heating - zänahitükam
centre - zän
    * dead centre = takät
century - tumyel
certain - fümik
certainly ! - dido, go fümö!
chain - jän; jänön
chalk - kret
chair - stul
    * an easy chair = kovenastul
chambermaid - jiklinükan
chamber-pot - neitaskal
chance - fäd, mögod
    * by chance = fädo
(to) change - (money) = cänön
  - (alter) = votükön
  - (become different) = ceinön)
    * small change = smalamon
    * loose change = lukönädamon
changeable (of weather) - nelaidik
channel - kanäd
chap (old friend) - bäldadan
chapter - kapit
character - kalad
characteristic - kaladik, kaladapatedik; patäd, kaladapatäd
charge - (homework, task) = bligäd
(to) charge - (load) = belodön
  - (to impose task) = bligädön
  - (accuse) = kusädön
    * to charge someone money for something = kalükön
charade - jarad
charm - keinot
(to) charm - tirädön keino
charming - keinik, löfidik
(to) chat - spikotön
chase - pöjut, yag
(to) chase - pöjutön, yagön
chassis - jasid
cheap - nejerik
check - (chess) = cög
cheek - (anatomy) = cüg
cheeky - mäpüdik
    * cheer up! = trodö!
cheese - fromad
chef - kvisinal
chemical - kiemik
chemist - (industrial) = kieman
  - (pharmacy) = drogöp, pötekan
chemistry - kiemav
cheque - cäk
cherry - cel
chest - (container) = bog
  - (anatomy) = blöt
chestnut - skäul
    * horse chestnut tree = skäulep
(to) chew - maskön
chicken - gokül
chief - le..., cif
    * chiefly = ledino
child - cil
    * a child-minder, a nanny = cilijikälädan
childishness - cilöfot
chilly - koldülik
chimney - cim
chimney-piece - cimamadür
chin - cün
china - (ware) = bösinot Tsyinänik
(to) chink - toenön
(to) chirp - tyilpön
chisel - nüsleiföm
chives - bebül
chocolate - jokolad
    * chocolate bar = jokoladatvilül
choice - väl
(to) choke - teafön
    * to choke s.o. = teifön (eki)
(to) choose - välön
chop - (cutlet) = ribotül
chopper (for food) - dacöpilöm
chopstick - fidastafil
(to) christen - (baptize) = blunedön
Christendom - kritanef
Christian - kritan, kritik
Christianity - krit
Christmas - kritid, kritidazäl
church - glüg
cider - podamust
cigar - zigar
cigarette - zigarül
cinema - bioskopöp
cinnamon - kirfat
circle - sirk, sirkül;
    * circle (in theatre) = parket
(to) circle (round) - sirkülön (zü)
circular - (communication) = sirkülapenäd
  - (shape) = sirkafomik
(to) circulate - sirkülükön; ziön
  - (in society) = kosädön
circulation - sirkülam
circumference - züot
circumstance - dinäd, jenot
circumstances - jäfät
cistern - cub
citizen - sifan
city - zif
civilian - sifädik
civilization - kuliv
(to) civilize - kulivükön
civil rights - sifagit
claim - flag; flagön
clairvoyance - kleililogam
class - (category) = klad
clatter - stur
claw - (animal) = kluv
clay - taim
clean - klinik; klinükön
cleaner - (ji)klinükan
cleanliness - klinöf
clear - kleilik
(to) clear - kulön
cleft - slitod
clergyman - kultan
clerk - penan; calan
clever - visedälik
client - dunetäb
climate - klimat
(to) climb (up) - grämön (sui)
(to) clink - toenön
clippers - jim
cloakroom - klotikipedön; klünacem
clock - glok
    * o'clock = düp
close - (nearby) = nilo, nilü
(to) close - färmükön
closed - pefärmüköl
cloth - (woven) = vivot
  - (material) = stof
  - (worsted) = köbamayän
clothes - klots
cloud - lefog
clover - träf
clownish - klaunöfik
  - (piece of) = flab
club - klub
clue (for puzzles) - geidavöd
clump - blög
coach - bökavab
coachman - bökan
coal - (stona)kolat
    * coalman = kolatan
coarse - grobälik, grobik
coast - jol
coaster - vejolnaföm
coastline - melajol
coat - gun, mäned
cobweb - spuled
cocain - kokain
cock - higok
cockatoo - kakad
cockroach - skaraf
cocoon - kokun
cod - gadut
code - kot
    * a code word = kotavöd
coefficient - (maths, physics) = koäf
coffee - kaf
coffee-pot - kafaskal
(to) cohabit - kelödön
coil - spül
coin - könäd
(to) coin - frapön
coincidence - kobojen
colander - sib
cold - kold, koldik
    * to catch cold = koldätikön
collar - kolet
(to) collect - konletön
collection - conlet
collective - koböfik
collectivity - koböf
collector - konletan
colonial - kolunänik
    * colonial produce = kolunänacans
colonist - kolunan, kolunänan
colony - kolunän
colour - köl, täin (= facial)
column - padül (= on page); kolum (= architecture)
comb - köb
(to) comb - köbön
combination - yümät
(to) combine (with) - yümätön (ko)
combustion - fefilükam
    * internal combustion = nifilükam
(to) come - kömön (lä, lü, nilü)
    * to come to one's senses = sevälöfikön
(to) come back - gekömön
comfortable - kovenik
comical - drolik
command - büd; büdön
commander - büdan
commander-in-chief - büdal
commandment - büd, büded
    * the ten commandments = büdeds deg
commerce - ted
commercial - tedik
commission - komit
    * on commission = komito
commissioner - lekomitäb
committee - komitetanef
common - (ordinary) = komunik
  - (customary) = kösömik
  - (having in common) = kobädik
commonwealth - kobälän
communication - kosäd
    * a communication cord (train) = ditretajänil
communism - kobädim
community - komot
companionship - kompen
company - kompenät
(to) compare (s.th. with) - leigodön (bosi lä)
comparison - leigod
compartment - (of coach) = vabadiläd
  - (for luggage) = päköp
  - (small) = dilädil
compass - kompad
(to) compel - mütön
(to) compete - mätädön (kol)
competent - duinafägik
competition - (all senses) = mäted
(to) complain - plonön (eke bosi)
complete - lölöfik
completely - loliko
compexion - (facial) = logodakölül
complicated - komplitik
composite - binädöl
compromise - balädikam
computer - nünöm
computer programmer - nünömaprogramel
(to) conceal - klänedön
concealment - kläned
(to) conceive - (imagine) = fomälön
  - (baby) = grodikön
  - (thought) = tikodön
conceivable - fomälovik
concept - suemod
conception - fomälam, tikod
concern - demäd, din, büsid
    * to concern = tefön
    * to be concerned for = labön demädi pö
concerning - tefü
concise - naböfik
(to) conclude - kludön
conclusion - fin, klud
concrete - kokret(ot)
(to) condemn - (sentence s.o. to) = cödetön eki ad
  - (misjudge) = micödön
condenser - densitükian
condition - (state) = stad
  - (terms) = stip
conduct - kondöt; kondötön
    * to guide = dugön
conductor - (person) = dugan
    * pipe, wire, material which conducts s.th. (water, heat, electricity...) = rüd, drat, stöf, kel dugodon bosi (vati, vami, lektini...)
(to) confess - (general) = koefön
  - (to admit) = lekoefön
confession - koef, lekoef
confessor - (ecclesiastical) = koefapatär
(to) confide - konfidön
confidence - konfid
confidential - konfidovik
(to) confirm - fümükön, zepön
confirmation - fümükam, zep
(to) conform (to) - lönülön (lü)
(to) confuse - bluv, kofud
(to) congratulate - benovipön
(to) play conkers - kastaenitaflapön
(to) connect - (train, etc.) = yümädön (ko)
  - (general) = yümätön (ko)
(to) conquer - konkerön
conqueror - konkeran
conquest - konker
conscience - konsien
conscientious - konsienöfik
conscious - sevedik
consciousness - seved
  - (spiritual) = datikäl
consecutive - sökaleodik
consent - däl; dälön
consequence - sek
consequent - sekik
(to) consider - lelogön, tikädön, vätälön, betikön
considering - vätälü (+ noun)
(to) consist (of) - binädön (me)
  - binälön (in)
(to) console - trodön
constancy - laid, laidäl
constantly - laiduliko
consulate - konsulöp
(to) consult - konsälidön, konsultön
consultation - konsult
contact - kontag (= physical); kosam (= personal)
(to come into) contact - kosikön
(to bring into) contact - kosükön
(to) contain - kipädön. ninädön
contemporary - timakompenik
    * a contemporary person = bäldotakompenan
contempt - nestüm
content - kotenik
contented - pekotenüköl
contentment - koten
contents - ninäd
contest - befeit
continent - kontinän
continental - kontinänik
continual - laidulik
continuation - fövot
(to) continue - fovön (me), fovön
continuity - yümöf
continuous - nenropik
(to) contradict - taspikön (eke) bosi
contradiction - taöf
contrary - gü, taädik
  - (contrary to = güä + noun)
(to) contribute - keblünön
contribution - keblünot
contributor - keblünan
control - kontrol
convenient - koveniälik
    * is this hour convenient for you? = Düp at, koveniälon-li ole?
(to) converge - kobikön
conversation - spikot
(to) converse - spikotön
conviction - süad
(to) convince - süadükön
cook - kvisinan; kvisinön
cooked - pekvisinöl
cool - koldälik, koldülik
cooler - koldülüköm
copper - kuprin
copy - kopied; kopiedön
    * copy (of book = samäd
coral - korial, korul (= colour)
cord - jain; lektina(le)fad (= electric)
cordial - ladöfik
core - piäf
cork - buon, koeg
corkscrew - koegitiret
corn - gren
cornea (eye) - korned
corner - gul
correct - verätik; verätükön
    * to correct work = koräkön bligädi
(to) corresond (with) - spodön (ko)
(to) correspond (to) - baiädön
correspondence - spod
correspondent - spodan
corridor - luyal
corset - korsät
cosmos - (si)leval, (si)lespad
cost - fräd
(to) cost - frädön
cottage - ludom, länädomil
cotton - kotin
    * cotton wool = vod
cough - kög;
(to) cough - kögön
council - konsälalef
    * Council Chamber = cäm
(to) count - nümädön
counter (in shop) - dünetatab
counterpane - löpateged
country - län, länäd
county - grafän
court - kur, yad
    * court of law = cödöp
courteous - plütik
courteousness - plütot
courtesy - plüt
courtier - kuran
courtyard - yad ninik
cousin - kös, hiköst, jiköst
cover - (general) = teg
  - (table linen) = tegäd
  - (bed linen) = teged
  - (hard cover) = tegod
(to) cover - tegön
covered - petegöl
cow - kun, jibub
(to) cower - blotön
coward - dredöfan
cowardice - dredöf
cowardly - dredöfik
crab - krab
crack - (fracture) = frakat
  - (burst) = kräk
  - (rent) = slitod
  - (bang) = tonät
(to) crack - brekön, kräkön
(to) crackle - knätärön
cranberry - redavaxen
crank (mechanical) - tülakurb
crash - stur
crate - krätäd
crater - kratär
crayfish - kref
crazy - lienetik
(to) creak - knirön
cream - krem
    * ice cream = gladet
    * whipped cream = flapilakrem
creamy - kremik
(to) create - jafön
creator - jafal
creature - jafäb
credit - kred, kredit
creditor - kreditan
creed - lekoef
(to) creep - kripön
crepe - veot
crew (on ship) - skip
cricket - carad, krik (= insect); krikät (= game)
crime - midun, krim
criminal - midunan, kriman;
  - midunik, krimik
crimson - karmisinik
crinoline - krinul
crisis - krisid
(to) criticize - krütön
criticism - krüt
(to) croak - kvagön
crocus - krok
crook - kanayan
cross - krod; travärön
    * crossroads = sütitraväröp
    * to cross the street = lovegolön love süt
    * to cross by water = lovebotön
(to) crouch (down) - kropikön
crouching - blotöfik
crow - krov
crowd - lemödot, menamödot
crown - kron
    * a crown coin = klon
cruel - kruälik
cruelty - kruäl
(to) crush - (tread down) = lepedön
  - (into powder) = troivön, troivülön
crust (earth's) - krut
cry - luvokäd; drenön, luvokädön
crystal - kristad
    * a crystal (radio) set = kristadaparat
cube - kübäd
cucumber - küg
cuckoo - kukuk
cuff (for shirt) - slivül
cunning - käfik
cup - (competition) = köp
  - (drinking) = bovül
cupboard - ramar
curable - sanovik
cure - lekäl; sanön
curiosity - nuläl
curious - nulälik
curl - herakrugül, krugül
curly - krugülaherik
currant - bäl
    * a black/red currant - ribedabäl
current - flum
curse - blasfäm; blasfämön
cursed - deätik; maleditik
curtain - körten
curve - krugalien
curving (winding) - krugik
cushion - kusen
custom - (habit) = kösömot; (traditional) = geböf
customary - kösömik
customer - laidareman, dünetäb
customs - (toll) = toläd
    * a customs officer = tolädan
cut - köt, kötäd; kötön
cutter (female) - jilajiman
(to) cycle - saikulön
cylinder - zilid
cynic - künidan
cynicism - künidim

-------------------- D--------------------

dad - fat, fatül
daily - aldelik, aldeliko
dairy - miligöp
damage - däm; dämükön
damp - luimöf, luimöfik, luimülik
dance - danüd; danüdön
    * dance tune = danüdüm
danger - riskäd
(to) dare - (venture) = riskön
  - (allow to) = dalön
dark - dag, dagik
darling - löfäb
date - (of month) = dät
  - (fruit) = daet
    * up-to-date = baitimädik
daughter - daut, jison
dawn - gödalulit
day - del
daybreak - delaprim
dazzling - tulitik
dead - deadik
deaf - surdik
(to) deafen - surdükön
deafening - lilämisurdüköl
deal - mödot
    * a great deal = bundano, lemödot
dealer - tedan
dean - dekätan
dear - (lovable) = löfik
  - (expensive) = jerik
death - deadam
debt - deb
debtor - deban, debetan
decadence - neben
(to) decay - (general) = rübikön
  - (teeth) = puridikön
(to) deceive - cütön
deceit - cüt
deceitful - cütik
December - dekul
decency - plüt
decent - plütik
deception - cütam, cütid
(to) decide to - sludön (ad)
decision - slud
deck - (of ship) = däk
deckchair - takädastul
declamation - deklam
(to) declare - stetön
declaration - stet
(to) decline - klemön
(to) decorate - dekön
decrease - nepluikam; nepluikön
decree - büad
(to) deduce - (infer) = kludön
deed - dun, dunot
deep - dibik
deer - stäg
defeat - peräd; vikodön
    * to bring about defeat = lüblinön perädi
defeatism - misekim
defect - def
defective - defik
defence - jelod
defenceless - nenjelodik
(to) defend - jelodön
defensive - jelodik
defiantly - todiko
(to) define - miedetön
definite - kuratik, miedik
definition - miedot
(to) defy - letodön
degree - (qualification) = diplom
  - (thermometer) = grad
  - (calibration) = gred
  - (mark, stage) = gredät
  - (high degree) = vem
    * by degrees = gredamo
delay - stopäd, zög
(to) delay - stopädön, zögön
(to) delegate - gividön
deliberately - desino
delicate - (fragile) = brekovik
delight - lejuit
delightful - dafredüköl, lejuitik
(to) deliver - (bring) = blünön
  - (releas e) = libükön
deliverance - blün, libükam
delivery - (in birth) = motam
demand - (insist(ask price) = flaged; flagedön
demonstration - jonetükam, meugijon
demon - diabil, diabül, milanan
den - sep
denial - noam
dense - (thick, fat) = bigik
dentist - tutisanavan
(to) deny - noön
(to) depart - detävön, motävön
department - diläd
departure - detäv, devegam, motäv
(to) depend (on) - sekidön (de)
(to) deposit - kipidön
(to) deprive (s.o. of s.th.) - sädütön (eke bosi)
depth - (general) = dib
  - (measure) = dibot
dervish - därvid
(to) descend - nexänon
descendant - licinan
descent - nexän
(to) describe - bepenön
description - bepenam
(to) desert - lüvön
(to) deserve - meritön
deservedly - meritabiko
deserving - meritabik
design - (sketch) = disin; disinön
desirability - desirab
desirable - desirabik
desire - desir; desirön
desirous - desirik
desk - püpit
despair - däsper; despärön
(to) despise - nestümön
dessert - poszib
(to) destine (for) - jonidükön
destiny - fät
(to) destroy - distukön
destroyer - distukan
destruction - distuk
detail - notet, pat
(to) detain - (delay) = stöpädön
determinative (grammar) - lüyümod
determination - fümetam, lonam
(to) determine - fümetön, lonön
(to) detest - naudön
(to) develop - daglofön; sävilupön (= photos)
development
daglof, jenäd
devil - diab, milanan
devilish - diabik, diabälik
(to) devise - datikön
(to) devote - liedietön, saludükön
devoted - divodik
devotion - devod, divod, saludükam
devout - relöfik
dew - dav, gödaluim
dewdrop - davatof
diameter - diamet
diamond - nidain
dictionary - vödabuk
(to) die - deadön
different - difik
difficult - fikulik
(to) dig - jüpön, sebön, tovädön
(to) digest - dicetön
digestion - dicet
dignified - gravik
(to) dignify - sikön
dignity - dinit, grav
(to) diminish - nepluükön
dimness - trub
(to) dine - fidedön
dining-car - staudavab
dining-room - fidalecem
dinner - fided
(to) dip - blunön
direct - nemedik, stedöfik, stedöfo
  - (to indicate way) = lüodükön
direction - lüod
disagreeable - neplitik
dirty - miotik
(to) disappear - nelogädikön
(to) disappoint - (expectations) = läsetön (speti)
  - (let s.o. down) = säspetükön (eki)
disappointment - läset
disapproval - micöd, micödot
(to) disapprove - micödön
disaster - katastrof
(to) disburden - säfledön
disc (compact) - sirkotül
discontented - nekotenik
discothèque - sirkotadanüdasälun
(to) discover - tüvön
    * to discover country = letüvön
discovery - tüv, letüv
discreet - prüdik
(to) discuss - bespikön
discussion - bespik
disdain - komunöf
disease - maläd
(to) disembark - säboidön (oki)
(to) disguise (o.s.) - votaklotön (oki)
disgust - naud; naudön
dish - (bowl) = bov
  - (course) = zib
  - (large) = skel
dishonest - nesnatik
(to) disinfect - sänäfätön
disintegration - sustonäd
dishwasher - bovilavacin
(to) disinherit - sägerükön
(to) dismiss - sädünükön
dismissal - sädünükam
display - seidet
(to) displease - neplidön
(to) dispose of - (get rid of) = moükön
  - (sell) = selön
disposed to - klienik ad
(to be at one's) disposal - gebidön lü
dissension - teläl
dissertation - penot
(to) dissolve - soilön
    * to solve a riddle = soülön rätili
distance - fag
distant - fagik
distillery - spitifabrik
distinct - distik
(to) distinguish - (differentiate) = distidön
distinguishable - distidovik
distinguished - stümik, süperik
(to) distribute - seagivön
distribution - dilam, seagiv
district - ziläk
(to) disturb - tupön
disturbance - lemuifükam, tup
ditty (short song) - priomalidil
(to) dive - daivön
diver - daivan
(to) diverge (from) - difön (de)
(to) divide - dilädön, dilön
(to) divide (by) (maths) - müedön (dub)
division - dilam, müedam (= maths)
divorce - matiteil
(to get) divorced - matiteilön
(to) do - dunön
    * to do without = nelabön
    * to do business = bligidön
dock - käv
doctor - dokan, sanan
document - doküm
dog - dog
doll - pup
dollar - dolar
domicile - topät
dominos (game) - dominov
(to) donate - givülön
donkey - cuk
door - yan
    * front door = leyan
    * a door knocker = noköm
double - telik
    * a double-barrelled gun = telrüdedagün
(to) double - telön
doubt - dot; dotön (dö)
doubtful - dotik
down (fluffy feathers) - daun
downstairs - dono
downwards - donio
dozen - degtelat
draft - riget (= rough copy); tret (= commercial)
(to) drag - tränön
dragonfly - libelul
(to) draw - (pull) = tirön
  - (make drawing) = däsinön
  - (attention to) = küpälükön
    * a drawing = däsinot
    * to draw a prize = tiredön
drawer - (furniture) = layet
(to) dread - dredön (demü, tefü, pro)
dreadful - dredabik
dream - drim; drimön
dress - (general) = klot
  - (lady's) = kloted, lädaklot
  - (suit) = klotem
    * dress circle (theatre) = bakun balid
    * a dress coat (with tails) = trelülagun
    * a dressing-table = klünatab
    * evening dress = zälülaklotem
(to get) dressed - klotön, lenükön klotis
drill (electric) - gimül (lektinik)
drink - drin, drinod; drinön
    * soft drinks = drineds nelalkoholerik
drive - (in vehicle) = vabam
  - (excursion) = spatavabam
    * to drive a vehicle = vabükön vabi
driver - joför
driving licence - toodamazöt
(to) drop - (let fall) = koedön falön, leadön falön
    * a drop (of liquid) = tof
(to) drown (s.o) - nöyön (eki)
drum - trum
    * a drum roll = trul
drummer - truman
drunk - brietik
dry - sägik; sägükön
dryness - säg
duck - dök
due - debik
    * the train is due at seven = tren mutön lükömöm tü düp velid
duet - telüm
dull - stupik, dofik, dölik, dumik, trubik
duly - kuratiko
dumb - müätik
duration - dul
during - (...the time that) = dü
dusk - soaralulit
dust - püf
dusty - püfik
duty - (obligation) = blig
  - (moral) = söt
    * duty free = fläno
(to) dwell - blibön, lödön
dwelling - löd, lödadom
dwelling-place - lödöp
(to) dye - kölön
dyke - daem

-------------------- E--------------------

each - al, alik
    * each time = alna
eager - ledesirik
eagle - kvil
ear - lil
earphones - kapakosädöm
early - gölik, göliko
(to) earn - meritön
earnest - fefik
    * in earnest = fefo
earth - (planet) = tal
  - (material) = tail
east - lofüd
easter - pasatazäl
easy - fasilik, nefikulik
(to) eat - fidön
ebony - bäad
edge - (blade) = köted
  - (border) = siem
  - (margin) = sim
edible - fidovik
edition - dabükot
editor - dabükan, redakan
(to) educate - (to bring up) = dugälön
  - (general) = kulivükön
  - (instruction) = tidön
educated - benodugölik, kulivik
education - dugäl, kuliv
eel - pil
effect - vobed, sek; vobedön
effective - jenöfik, vobedik, vobiälik
effects - (possessions) = dalabots
effervescence - gas bruidik, löbruid
effort - steifül, töbid
egg - nög
egg-plant - berjen
eiderdown - lestekateged
eight - jöl
eighteen - degjöl
eighty - jöldeg
either ... or - u ... u
  - ud ... ud (before vowel)
elaborate - ledunöfik
elbow - kubit
electric - lektinik
electricity - lektin
electronics - leätronav
elegant - klotugik
elefant - leefad
element (chemical) - lömin
eleven - degbal
elm - lorm, lum
eloquence - spiköf
else - votik, voto
elsewhere - votaseimo
(to) emancipate - sipön
embankment - käv
(to) embitter - bietälükön
(to) embrace - bradön
(to) emphasize - kazetön
empire - lampörän, reigän
(to) employ - (professionally) = cälön
  - (to use generally) = gebön
  - (to make o.s. useful) = jäfükön oki
  - (non-professionally) = vobükön
(to) be employed - binön cäläb/vobükäb
employee - cäläb, vobükäb
employer - cälan, vobükan
employment - (profession) = cal
  - (job) = jäfot
    * employment (=business) = büsid
empty - vagik; vagükön
(to) enact - zepön
(to) encamp - tänadöpön
encounter - (meeting) = kolköm; kolkömön
(to) encourage - kuradükön
end - fin, finot
(to) end - finidön, finikön, finükön
enemy - neflen
energetic - vilälik
energy - (physics) = nämet
  - (human) = viläl
(to) engage - matirajanön (ko)
engaged - (occupied) = beseidik
engagement - (betrothal) = matirajan
engine - (machine) = cin
  - (locomotive) = lemüf
  - (car, bus) = motor
engineer - (chief) = kaenal
  - (mechanical) = cinädan
(to) enjoy - fredön, fredükön, juitön
enmity - neflenam
enormous - levemik
enough - saidik, saidiko
enquirer - seividan
(to) enter - ninikön, nügolön, nükömön
enterprise - (arts & crafts) = feb
(to) entertain - (wine & dine) = daifidön
  - (receive as guest) = getedön
  - (amusement) = muadön
enterprise - febäd
entertaining - muadik
entertainment - daifid, muad, säjäfälükam
enthusiasm - lanäl
enthusiast - lanälan
enthusiastic - lanälik
entire - lölik
entrance - nügolöp
envelope - köv; kövön
envious - mibönik
environment - züamöp
envy - mibön; mibönön
episode (radio / TV) - näijenot
epithet - läod
equal - leigik
equality - leig
equally - leigiko, leigoso
equestrian - monit
    * an equestrian statue = monitanamagot
equilibrium - leigavet
(to) equip - blimön
equipment - blimot
(to) erase - radön
eraser - radagum
error - pöl
escalator - rolatridem
escape - mofug, skeap; skeapön, mofugön (de, se)
Eskimo - Läskioman
especially - pato
estate - länilabot
esteemed - lestümik
    * highly esteemed = dalestümik
(to) estimate - täxetön
etc. - e.r. (e ret, e rets)
eternal - laidüpik
eternity - laidüp
(to) evaporate - vapikön
even - (level) = kamik; kamükön
  - (notwithstanding) = igo
evening - soar
evenly - leigöfiko
event - jenot
    * in any event = alo
eventful - veütik
ever - (at all times) = ai
  - (at any time) = föro
    * ever since = siso
every - alik
everyone - dabinanef, valikans
everywhere - valöpo
evidence - klülab
evident - klülabik
evidently - klülabiko
evil - bad
exactly - kuratik, kuratälik, stediko
exaggeration - tuükam
(to) exaggerate - tuükön
examination - vestig, xam
(to) examine - vestigön, xamön
examiner - vestigan, xaman
example - sam
    * for example = as sam / äs sam
(to) exceed - pluön (demü, tefü, in)
exceeding - plödakösömik
exceedingly - plödakösömiko
(to) excel - (distinguish o.s.) = benodistükön oki
  - (to abound with) = pluön lä
excellent - cädik, süperik
except - pläamü
exception - pläam
exemplar - dasaman
exercise (physical) - tur
excess - plumaf
excessive - plumafik
(to) exchange - cänön
exchange rate - cänakursüd
(to) excite - (stir up) = fäkädükön
  - (stimulate) = stigedön
excitement - stiegedam
(to) exclaim - vokädön
exclamation - vokäd
(to) exclude - fakipön, plödakipön
excluding - fakipü ..., plödakipü ...
exclusively - te
excursion - zugot
excuse - säkusad; säkusadön
exercise - okskilükam, bligäd
    * physical exercise = koapaskilükam
(to) exhaust - lefenükön, nenämükön
exhausted - lefenik
    * to be exhausted = lefenön
exhaustion - lefen
(to) exhibit - dajonädön
exhibition - dajonäd
(to) exist - dabinön
existence - dabin
exit - segolöp
(to) expand - pakön
expansion - stäänükam
expenditure - fegeb
expense - fräd, fräds
expensive - jerik
experience - plak
experienced - plakugik, plobik
experiment - sperimänt
experimental - sperimäntik
    * experimental stage = stadäd sperimäntik
(to) explain - kleilükön, plänedön, plänön
explanation - plän
(to) exploit - tufrutidön
exploration - vestig
(to) explore - vestigön
explorer - vestigan
(to) express - notodön
expression - notod
(to) extend - stäänikön (love)
extensive - lardik
external - plödik
(to) extinguish - kvänön
extra - läfulükik
(to) extract - sätratükön, setirön
extraordinarily - nekösömiko
extraordinary - nekösömik
extreme - lemuam, lemuik
extremely - levemo, lemu
extremity - (superlative degree) = lemuam
  - (poin, tip) = finot
eye - log
    * an eye clinic = logasaunüköp
eyebrow - logabob
eyelid - logalip

-------------------- F--------------------

face - logod
facility - fasilot
facing - visoik
fact - jenöfot
    * in fact = ibo, jenöfo
factory - fabrik
(to) fade - fainikön
(to) fail - defön
faint - lefenik; svenön
faint-hearted - dredöfik
fair - (not dark) = blonik
  - (honest) = snatik
  - (seemly) = gidöfik
fairness - gid
    * in fairness to = ko gid kol
fairy - fey, feyik
fairyland - feyalän, märalän
fairy-tale - mär
faith - (general) = fied
  - (trust) = konfid
  - (religion) = lekred
faithful - fiedik, lekredik
falcon - falok
fall - fal; falön
    * fall in prices, temperature, etc. = nepluikam; nepluikön
(to) fall asleep - slipikön
(to) fall in love with - lelöfädiköm dö
(to) fall ill - malädikön
false - dobik, dobälik
falsehood - dob, dobäl
fame - fam
familiar - komunöfik, nätimik
familiarity - komunöf, nätim
family - famül
famine - faemaditret
famous - famik
fancy - (imagination) = fomäl
  - (day-dreaming) = magäl
  - (fantasy) = magälod
fanfare - tambur
far - fagik
farewell - ledit
farm - farm, farmadom; feilön (me)
fashion - vogäd
fashionable - vogädik
fast - (religious) = cun; cunön
  - (fixed) = fimik
  - (speedy) = vifik
(to) fasten - (fix) = fimükön
fat - (ample) = bigik
  - (stout) = pinädik
fatal - mifätik
fate - fät
father - fat, hipal
father-in-law - lüfat
fault - midun, döbot
favour - gön; gönön
favourable - gönik
fear - dred; dredön
feather - plüm
feathered - plümilabik
federal - fedik
feeble - fibik
(to) feed - nulüdön
(to) feel - (ill, well) = senön
feeling - sen, senäl
February - febul
fellow - kompenan, hikompenan
    * a fellow- countryman = kelomänan
(to) fetch out - süramenön
female - vomik
fence - (hedge) = buid; buidön
  - (wood) = kiud; kiudön
    * to fence (sport) = fegön
    * to fence off = deteilön
fern - filig
fertile - fluköfik
festival - zäl
(to) fetch - ramenön
fever - fif
feverish - fifilik
few - nemödik
fiasco - misek
field - (general) = fel
  - (enclosure) = feled
  - (terrain) = läned
fierce - (wild) = sovadik
  - (wrath) = lezunik
  - (angry) = zunik
figment (of imagination) - fomälod
fight - komip; komipön ta
figure - (illustration) = figur
  - (appearance) = kopafom
  - (numeral) = numat
file - (archive) = ragiv
  - (tool) = räp
(to) fill - fulikön, fulükön
film - bioskop (= movie); film, filmod (= substance)
    * a film star = bioskopastelan
(to) film - filmön
fin - (fish) = stiragöb
final - finik
finally - fino
finch - janafrin
(to) find - tuvön
fine - (not dense) = feinik
  - (in order) = jönik
  - (penalty) = monapönod
finger - doat; doatön
(to) finish - (complete) = fimekön
  - (conclude) = finükön
fir - fir
    * a fir cone = konüd
(to) fire - (weapon) = jütükön
fireguard - treil
fireplace - filetatopafön
firm - (enterprise) = fiam
  - (fixed) = fimik
  - (certain) = fümik
  - (persevering) = laidälik
  - (solid) = solidik
firmness - laidäl
first - balid
    * in the first place = büiküno
firstly - balido
first-rate - balidkladik
fish - fit; päskarön
fisherman - (hi)päskaran
fist - pun
fit - (opportune) = pötik
  - (qualified) = skilik
  - (suitable) = lönedik
five - lul
(to) fix - fimükön
flag - stän
flake - flog
flame - flam; flamön
    * to flame up = löflamön
flash - kämalelit (= photographic); leklär (= of lightning)
käramalit, pokalampad (= flashlight)
flat - (level) = platik
  - (even) = plenöfik
    * a flat (in bigger block) = lödatead
(to) flatter - flätön
flattery - flät
flea - flib
(to) flee - (run away) = mofugön
fleet - nafem
flesh - (human) = mid
flight - (air travel) = flit
  - (of stairs) = vüplatedtridem
flimsy - voalaslenik
(to) fling - lejedön
float - (raft) = floted; flotön
(to) flock (to) - trupön (lü)
floor - glun, tead
flour - lemeil
flow - (of liquid) = flum; flumön
    * to flow around = züflumön
flower - flor; florön
(to) fly - (in sky) = flitön
  - (escape) = defugön
  - (flee) = fugön
    * a domestic fly = musak
    * a UFO = yeg flitöfik no padientifüköl
foam - sköm
fog - fog
fold - plif; plifön
(to) follow - (on) = fovön
  - (after) = sökön
  - (mentally) = suimön
following - sökik, sököl
fond - lelöfädik
food - fid, nulüdöt, zib
fool - fopan
foolhardy - lukünik
foolish - fopik
foot - (body part) = fut
  - (in verse) = liänülam
football - futaglöpäd
footbrake - futafrenöm
for - (preposition) = ad, pro
  - (conjunction) = ibä
(to) forbid - proibön
force - näm; mütön
fore - föfo
    * to the fore = lü (sui) föfaglun
forecast - (to predict) = büosagod; büosagön
    * weather forecast = büosagod stoma
forefather - büröletan
forehead - flom
foreign - foginik, foginänik
foreigner - foginänan
foreman - (of jury) = cif yulacödalefa
forename - pösodanem
forenoon - büzedel
forerunner - büogolan
(to) foresee - büologön
foresight - büologam
forest - fot
forester - fotikonöman
forestry - fotikonöm
(to) foretell - büosagön
forethought - desin
forever - ai, laidio
foreword - fovöd, fonun
(to) forget - glömön
forgetfulness - glömäd
(to) forgive (s.o. s.th.) - pardön (eke bosi)
forgiveness - pard
fork - fok
forked - zikzakik
form - (shape) = fom; fomön
  - (seat) = bam
  - (to fill in) = fomet
  - (form of address) = lüspikavöd
formerly - vönädo
fortification - fortif
fortnight - telvig
fortune - benofät
fortunate - läbik
fortunately - läbiko
forward(s) - föfio, föfiö!
foster-child - hi/jikäläb
foster-parent - hi/jikälan
fountain-pen - fulükapen
(to) found - (establish) = fünön
four - fol
    * in fours = folo
fowl - böd, gok, higok, jigok
fox - renar
    * fox fur = renarapläd
fracture - brekod
fragile - brekovik
(to) fragment - brekotön
frame - (base-frame) = jasid
  - (to frame) = fremön
  - (window-frame) = fenätafrem
  - (to put into words) = fomätön
framework - skelät
franc (currency) - fran
frank - stedälik
frankly - stedäliko, stedälo
free - libik
freemason - lelivamasonan
(to) freeze - flodön
    * to freeze to death = deiflodön
    * to freeze an action = flodöfön
freezer - flödacin, flödöm
freighter - fledanaf
frequent - dünuamik, suvöfik; visitön suviko
frequently - dönuamo, suöfikna
fresh - (new) = flifik
  - (chilled) = koldülik
Friday - fridel
fried egg - loetanög
friend - flen
friendly - flenöfik
friendship - flenalöf
fright - jek
(to) frighten - jekön, jeikön
frog - frog
frolicsome - badöfafredik
from - de
    * from then on = denu, sisoik
front - (forehead) = flom
  - (forefront) = föfaflan
  - (military) = front
frontier - mied
frost - flod
frosty - flodik
frugal - späliälik
fruit - fluk
frustration - neodül
(to) fry - loetön
frying pan - loetamapaäl
fuel - filamastöf
(to) fulfil - fölön
full - fulik
fun - cog
function - jäfid (= general); sekät (= maths)
fun - drol
    * to have fun = böfön
funeral - (interment) = sepülam
  - (funeral party) = sepülanef
funnel (of ship) - kaskod
funny - cogik, drolik
fur - pläd
furious - lezunik
furnace - fön, lefön
(to) furnish - (chairs, etc.) = möbön
  - (to fit out) = blimön
furniture - (items) = möbs, möbem
(to) further - födön
furry - plädik
fury - vut
furtively - lükölo
future - fütür, fütürik

-------------------- G--------------------

gaiety - lefred
gaily - lefrediko
gain - gaenod; gaenön
galaxy - galakid
gallery (theatre) - bakun kilid
game - (play) = pled
gangway - golaboed
garage - garad
garden - gad
(to) garden - gadön
gardener - gadan
garlic - läl
gas - (petrol) = bänsin
  - (gasworks) = gasin
  - (natural) = vap
gate - leyan
(to) gather - (gather) = kädedön
  - (include) = ninükön
  - (bring in) = nüblinön
  - (crops) = klopön
  - (meet) = kobikön
  - (pick) = plökön
    * to gather (mentally) from = kludön se
gathering - (collection) = käded
gauze - gaod, veot
gay - (happy) = lefredik
  - (homosexual) = otgeniälik
(to) gaze - logetön (föfio)
gear stick - traböm
geese - gans
gene - gered
general - (person) = general
  - (universal) = valemik
generation - menäd
genitals - genäms
genius - (tutelary) = jelalan
    * man of genius = letälenan
gentleman - siör, söl
genuine - legik
geographic - taledavik
geography - taledav
gesture - jäst
(to) get - getön
(to) get rid of s.o. - nelabükön bosi
(to) get up - (rise) = löadön (de/se)
geyser - gäysär
ghost - lan, späk
giant - gian, gianagretik
gift - legivot
gigantic - gianik, gianagretik
gill - (fish) = ciel
gimlet - gim
girl - jipul, jicil
(to) give - givön, gevön
    * to give rise to = süükön
    * to give way (under) = sukubön (sekü)
glad - fredik
glance - loged viföfik
(to) glance through - luxamön
gland - glan
glaring - tulitik
glass - (material) = glät, glätik
  - (drinking) = vär, väret
(to) glean - gleinön
(to) glide - slifön
gloom - glum, glumäl
gloomily - skano
gloomy - glumik, glumälik
glorious - glorik
glory - glor
glow - glut; glutön
glum - favik
gnat - muskitil
(to) go - (on foot) = golön (ad, len, lü, ve)
  - (in vehicle) = vabön (me)
goalkeeper - zeiligaledan
goat - (nanny) = jikapar
  - (billy) = hikapar
(to) go away - mogolön
(to) go out - plödikön, segolön
(to) go to bed - golön lü bed
godchild - hi/jispönäb
godparent - hi/jispönan
gold - (ore) = goldin
  - (golden) = goldik
goldfish - ziporüt
goldsmith - goldismitan
golf - gold (game)
gong - goun
good - gudik
good-bye - adyö!
good-tempered - benovimik
    * bad-tempered = mivimik
goose - gan
gooseberry - stigaribedabäl
goshawk - gokahauk
gossamer - lutofad
Gothic (type) - fraktur
(to) gossip - kagön
gout - gig
(to) govern - guverän
government - reiganef
grace - benäd, kein
    * with good grace = keino
    * with bad grace = nekeino
graceful - keinik
gracious - benädik
gradation - gredam
grade - gred
gradual - gredik
gradually - pianiko
graduate - (university) = gredätükäb
    * to graduate (at university) = gredätükön
(to) graft - grifön
granddaughter - posdaut
grandfather - lefat
grandmother - lemot
grand-piano - göbapianod
grandson - posson
(to) grant - dälön, gevön
grasp - gleip; gleipön
grass - yeb
grasshopper - krikül
(to) grate (irritate) - knirön
grateful - danöfik
(to) gratify - kotenükön, plitön
gratis - (free of charge) = glato
gratitude - danöf
grave - (tomb) = sepül
  - (serious) = fefik
gravel - gronaston
gravity - fef
    * gravitation = vetotanäm
great - gretik
great-grandfather - dalefat
great-grandmother - dalemot
green - grünik
greet - glidön
greeting - glid
grey - gedik
grief - glif
(to) grieve - glifön, glifükön, lenofön
grievous - glifik
(to) grind - (small) = grainön
(to) grin - grinedön, grinön
(to) groan - hagön
ground - glun, glunot
ground floor - donatead
group - grup; grupön
(to) grow - (animals, plants) = bridön
  - (general term) = glofön
  - (to become) = vedön
growth - glof
(to) grumble - murön
guard - (watchman) = galedan; galedön
    * railway guard = trenigaledan
guardian - tütan
(to) guess - (conjecture) = niludön
  - (puzzle out) = rätön
  - (to find out) = tuvedön
    * I'm up to your tricks = etuvob käfodis ola
guest - lotan, lotidan, lotidäb, vüdäb
guest-room - lotidacem
guidance - lüodäl
guide - (person) = geidan; geidön (eki)
  - (book) = geidian
guild - döb
guiltless - nendöbik
guilty - döbik
guinea-pig - kavead
gullet - slug
gum - (in mouth) = gingif
  - (chewing-gum) = maskagumod
gun - (shot-gun) = gün
  - (canon) = kän
gunpowder - pur
gymnasium - turöp

-------------------- H--------------------

habit - kösöm, kösömot
habitual - kösömik
habitually - kösömo, kösömiko
hail - gräl; grälön
hailstone - grälaston
hair - her, herem
    * hair loss = herasefal
    * (hair) parting = heremiteil
    * hair oil = pin
    * hair tongs = zäp
hairbrush - heremikef
hairdresser - (ji)heran
hairdryer - heremisagüköm
hairstylist - heremamastan
half - laf, lafik
half-an-hour - düpatelid
hall - lecem
ham - ham
hammer - fög
(to) hammer - fögön
hand - nam
    * a clock hand = jonian
    * a hired servant = loatäb
    * to have at/to hand = gebidön (dö)
handbag - (lady's) = saked
handkerchief - pokasärvätül
handle - gleipäd, gleiped;
    * to handle tools etc. = tölatön
handsome - nobik, jönik
handwriting - penät
(to) hang - (down, up) = lagön
  - (s.th.) = lägön
(to) happen - jenön
happiness - fred, läb
(to make) happy - gredükön, läbükön
harbour - pof
hare - liev
hard - düfik, fikulik
    * hard labour = mütavob
hardening - düfikam
hardness - (material) = düf
hardly - (scarcely) = töbo
harebell - luäg
harm - däm; dämön
harmful - dämik
harmless - nendämik
harmonious - baitonik
haste - spid
hastily - spido
hat - hät
hate - het; hetön
harvest - klopüp; klopön
haste - spidiäl
(to) have - labön
hawk - falok
hawker - kolportan, lutedan
hawking - beluted
hay - sigayeb
    * a hay loft = sigayebamasad
hazy - fogül
(to become) hazy - fogülön
he - om
head - kap, cif
headache - kapadol
headlight - fläkömalampad
health - saun
healthy - saunik
heap - kum
(to) hear - lilön
hearing - (sense of) = lilasien
heart - lad (hard-hearted = düfaladälik)
    * by heart = nenbuko
    * heart and soul = binäl
hearth - filetatop, filetatopafön
heathland - brüyäralän
heartily - ladöfiko
hearty - ladöfik
heat - hit; hitükön
heated - hitik
heater (electric) - hitöm
heather - brüyär
heatshield - tahitajeläd
heaven - sül
heavy - vetik, vetöfik
heel - hil
help - yuf; yufön
hen - jigok
hence - denu, isao, sekü atos
henceforth - denu, de tim at, fovo
henceforward - denu, de tim at, fovo
herb - keb
here - is
hermetic - härmetik
hero - heroedan
heroic - heroedik
heroine - juheroedan
heroism - heroed
heron - härod
herring - hareng
(to) hesitate - zogön
hesitation - zog
heterosexual - votageniälan
(to) hide (o.s.) - klänedön (eki)
(to) hinder - stöpädön
hindu (= person) - hindutan
high - geilik
    * High Street = cifasüt
highway - lesüt, leveg, vabamakul
higgledy-piggledy - pemiko
hill - lubel
hip - (anatomy) = hip
(to) hire - loatön (eke bosi)
    * hire fee = loatamon
historian - jenavan
historic(al) - jenavik
history - jenav
hit - flap; flapön
hither - isio
hitherto - jünu
hobby - löfäl
hockey - hokiy
hoe - cop
hood - kapüt
hoist (mechanical) - tovian
(to) hoist (up) - tovedön
(to) hold - dakipön, kipön
    * hold of a ship = lodaspad
hole - hog
    * the black hole = siblägahog
holiday - vaken, zäladel
holiness - salud
hollow - kev, kevöfik
holy - saludik
holly - liäg
home - lom, lomio, lomo
homosexual - otgeniälan
honest - snatik
honesty - snat
honey - miel
honeycomb - mielaziöbem
honeymoon - matedatäv
honour - stim; stimön
hoof - (animal) = saf
hook - huk; hukön
(to) play at hoop and hook - rifedön
hop (for beer- making) - humul
(to) hop - bunülön
hope - spel; spelön
horizon - horit
    * on the horizon = tö horit
horn - (on animal) = hon
  - (musical) = horn
hors-d'oeuvre - büzib
horse - jevod
horsepower - jevodanäm
horse-radish - räfor
hospital - malädanöp
hospitality - lotidiäl
hostess - hi/jidaifidan
hot - hitik
hotel - lotidöp
hour - düp
    * per hour = a düp
    * an hour and a half = düp bal e lafik
house - dom
household linen - vietastofäd
how? - lio?
however - too, ye
human - menik
humane - menälik
humanity - menät
(to) humanize - menätükön
humble - mükik
humid - luimöfik
(to) humiliate - mükükön
humiliation - mükükam
humility - mük
hundred - tum
hunger - faem
hungry - faemik
(to be) hungry - faemön
hunt - yag; yagön
hunter - yagan
hurry - spid; spidön
hurt - (pain) = dol; dolön
  - (injury) = viod; viodön
husband - himatan, matan
hut - ludomil
hyacinth - hüasen
hyena - hüen
hypnosis - hüpnod
hypocrite - simulan

-------------------- I--------------------

I - ob
ice - (frozen water) = glad
  - (ice cream) = gladül
  - (ice hockey) = gladahokiy
Iceland - Lisladän
idea - tikamagot
ideal - dial, dialik
(to) idealize - dialön
idle - (lethargic) = nevobik; nevobön
  - (unoccupied) = nenvobik
  - (shiftless) = trögik; trögön
idleness - (inactivity) = nosdun
  - (shiftlessness) = trög
idler - (person) = nosdunan
idly - nevobiko, nendesino, trögiko
    * aimlessly = nendesino
idiotic - diotik
if - if
igloo - gladadom (Läskiomik)
ignition - filid
ignorance - nennol, nensev, nesev
ignorant - nennolik, nensevik, nesevik
ill - maläd
ill-tempered - mivimik
    * good-tempered = benovimik
(to) illuminate - litükön
illumination - litükam
(to) illustrate - magodön
illustration - magodam, magod
image - mag, magod
(to) imagine (something) - magälön (bosi)
(to) imitate - sümädön
    * to ape s.o. = züpädön eki
imitation - sümäd, sümädot, züpäd
immediate - sunädo
immense - levemik
immoderate - nestönik
imp - diabül
impolite - neplütik
(to) import (goods) - nüveigön
important - veütik
impossible - nemögik
(to) impregnate - prägenön
(to) impress - (stamp) = stäpedön
  - (senses) = magädön (pö)
  - (on the mind) = stäpodön
impression - stäpedot, magäd
impressive - magädabik, magädafägik
(to) imprison - fanäbükön
improper - negidöfik
(to) improve - gudikumön, gudükumön, menodön
improvement - menod, gudükumam
impulse - stigäd
in - (place) = in
  - (time) = ün
incapable - nefägik
incessant - laidulik
inch - puid
incident - jenot
incidental - fädik
incision - kötädil
inclined (to) - (disposed) = klienik
(to) include - ninädön, ninükön
inclusion - ninükam
inclusive of - keninükamü...
income - lemesed
inconceivable - nesuemovik
inconsequent - nekludöfik
inconvenience - nekoveniäl
inconvenient - nekoveniälik, neplidik, tupik
increase - glof; glofön
  - pluikam; pluikön
incredible - nekredovik
incurable - nesanovik
indebted - debik
indeed - dido, jenöfo; jenöfö!
indefinite - nefümik
    * to put off indefinitely = cögön dü tüp nefümik
India-rubber - gum Lindänik
(to) indicate - jonön
indignant - leskanik
indignation - leskan
indigo - lindigot
indisposed (to) - neklienik (ad)
indistinct - nekleilik
(to) induce - stigädön
inductor - nidutian
indulgent - dälälik
industrial - dustodik
industrious - vobiälik, zilik
industry - dustod, vobiäl, zil
ineffective - nenvobedik
inexpensive - nejerik
inexperienced - nenplakik
(to) infect - näfätön
infection - näfät
inferior - bapik
(to) inflate - bladosvolükön
inflation (economics) - niflat
influence - flun; flunön
influential - flunilabik
in - folio (album) - fliodabuk
(to) inform - nunön
information - (office) = nünamabür
informative - nüniälik
ingenuous - nüniälik
ingratitude - nedanöf
(to) inhabit - lödükön
inhabitant - lödan
(to) inherit - gerön
inheritance - gerot
inheritor - geran
(to) inject - nüskutön
(to) injure - dämükön, viodön
injury - däm, viod
ink - nig
inkwell - nigiär
innocence - nedöb, nennefölot, nensin
innocent - nedöbik, nennefölotik, nensinik
inoffensive - neskänik
(to) inquire - säkön, seividon
inquirer - seividan
inquiry - säk, seivid
inquiry office - nünamabür
inquisitive - nulälik
insane - lienetik
insect - näsäk
insecure - nesefik
inside - nin, ninik, nino
    * inside right (football player = nidetatatakan
insignificant - pülik
  - (to make oneself insignificant) = blotükön (oki)
(to) insist - flagedön
  - (to) insist on one's own view : - blibön su tikädöp okik
  - blibön pö ced okik
(to) inspect - dalogön
inspection - dalogam
inspector - dalogal
instance - (case) = jenet
  - (example) = sam
  - (occurrence) = stadät
    * in the first instance = pö stadät balid
    * at the instance of... = flagü
instantly - sunädo
instead - (preposition) = pla
  - (conjunction) = plas
    * if I were you = if binoböv pla ol
instep (of shoe) - gared
(to) instruct - tidön
instruction - lejonod, tid
instructive - tidaliegik
instructor - tidal
instrument - stum
(to) insulate - siolön
insult - nof; nofön
insurance - sur
(to) insure - surön
intact - nätik
intelligence - sagat, vised
intelligent - sagatik, visedik
(to) intend - desinön
intention - desin
interest - nited, nitedäl; nitedön, nitedälön (dö)
    * (cash) interest = fien
interesting - nitedik
(to) interfere - vügolön (vü)
interference - tup
interior (of country) - nilän
internal - ninik
    * internal combusion = nifilükam
(to) interrupt - ropön
interruption - rop
(to) interview - bevüsagön
intestine(s) - ninäm(s)
into - ini
(to) introduce - nüdugön
inroductory - nüdugik, nüdugöl
insert - ninädianil
(to) invent - datuvön
invention - datuvot
inventor - datuvan
investigation - vestig
invitation - vüd
(to) invite - vüdön
iron - (metal) = fer
  - (smoothing-iron) = smufükammafer; smufükön
  - (iron ore) = ferinamün
irresistible - netadunovik
irresolute - nefümälik
(to) irritate - skänön
island - nisul
isolated - soelölik
it - on, os
item (single) - balat, (written) = notet

-------------------- J--------------------

jack - (car-raising device) = tovöm
jackal - jakal
jacket - jakät, yäk
jam - kompot
jaw - maxül
January - yanul
javelin - sped
    * javelin throw = spedijedam
jealous - jaludik
jealousy - jalud
jet-propelled - skutilemofik
    * a jet (aircraft) = skutaflitöm
    * a jumbo jet = leskutaflitöm
jewel - bijut
jeweller - bijutel
    * a jeweller's shop = bijutel
jewellery - bijutül, bijutüls
job - vob, vobod
(to) join - yümön
    * Come and join us! = Lükömolös lü obs!
joke - cog; cogön
journalist - gasediman
journey - täv; tävön
joy - fred
jubilantly - yöbölo
judge - cödal; cödön
judgment - cödot
jug - luflad
juggler - hestan
juice - vaet
July - yulul
(to) jump - bunön
jump - bun
    * high jump = geilotabunam
    * long jump = fagotabunam
June - yunul
just - (fair) = gidik
  - (just now) = ebo
  - (scarcely) = töbo
justice - gid
justification - gitod
(to) jut out - seädön

-------------------- K--------------------

kangaroo - kangur
kayak (boat) - kayak
keen - (sharp) = japik
(to) keep - (maintain) = kipedön, laibinükön
  - (retain) = kipön
kelp - varäk
kernel - püt
kettle - cafed
    * a kettle drum = timpun
key - kik (= for door); klav (= for musical keyboard)
key-hole - kikahog
    * key-hole surgery = dalukötetav
kick - tridod; tridodön
kidney - roin
kidney bean - vietabon
kilometre - milmet
(to) kill - deidön
kind - (polite) = flenöfik
  - (kind-hearted) = gudälik, löföfik
  - (category) = sot
king - hireg, reg
kiss - kid; kidön
kitchen - kvisinöp
knave (of hearts) - köraman
knee - kien
knickers - sleafablit
knife - neif
knight - kavidan
(to) knit - trikön
    * a knitting needle = trikanad
(to) knock - nokön
knob - gnob
knot - snob; snobön
(to) know - nolön, sevön
knowledge - nol
known - sevädik
Koran - Kuraan

-------------------- L--------------------

laboratory - sperimäntöp
laborious - vobiälik
labour - vob, vobod
    * hard labour = mütavob
labourer - voban
lace - led
lack - dev, nelab; defön, nelabön
ladder - xänöm
lady - läd
lake - lak
lamb - jipül
lamp - lampad, lantär (= decorative)
lance - sped
(to) land - (on shore) = jilön
lane - lusüt
language - (phrasing) = fraseod
  - (community) = pük
  - (expression) = spikamamod
large - gretik
lark - (bird) = laud
laser - laser
last - lätik, lätiko; dulon
    * at last = fino
    * last of all = lätiküno
last night - äneito
last week - ävigo
late - (tardy) = latik, lato
    * at the latest = lätiküno
lather - sobasköm
lattice - laed
(to) laugh (at) - smilön (dö)
laughter - smil
laundry - (place) = lavastitod
  - (washing) = lavastofädem
lavatory - (general) = tvalet
  - (on bus, trains) = prifet
law - lon, lonem
    * by law = lono
lawn - yebafel
lawsuit - cödäd
lawyer - lavogan
(to) lay (with concrete, etc) - beseitön
(to) lay (railway line, garden) - meikön
laziness - trög
lazy - trögik
(to) lead - dugön, stirikön (steer)
lead - (metal) = plumb, plumbin
leaden - plumbik
leaf - bled
leafless - nenbledik
leaflet - bledil
    * pamphlet = pämod
leafy - bledagik
league - fed
    * to be in league with / against = fedön (ko / ta)
lean - (not fat) = mägik
(to) lean - klivön
    * to lean against = stutön (ta)
(to) leap - bunön
leap-year - vüpladotayel
(to) learn - lärnön, lelilön
least - nemu, pu
leather - küir, küirik
leave (armed services) - livod
(to) leave - lüvön
    * (to) leave (behind) = posbinükön
lecture - komoreid; spikäd
(to) lecture - komoreidön, spikädön
leek - porud
left - nedetik
    * on the left = nedeto
leg - lög
legation - legät
legend - konäd
leisure - livüp
lemonade - limonad
(to) lend s.th. to s.o. - prünön (eke bosi)
length - (geographical) = lunet
  - (spatial) = lunot
lenient - dälälik
lens (eye) - lentül
lentil - lentül
leprosy - leprad
less - nepluik, läs, neplu
    * less and less = ai neplu
lesson - lärnod
lest - dat no...
(to) let - (lease) = bailön (eke bosi)
    * let us go! = golobsöd!
letter - (communication) = pened
  - (of alphabet) = tonat
letter-box - penedabog
lettuce - salad
level - nivät, nivod
level-crossing - (railway) = trenavegamöp
lever - tovian, tovömatig (= arm)
liar - lugan
liberty - lib
library - bukem
lid - tegot
(to) lie (lay, lain) - seatön
lie - lug; lugön
life - lif
lift - lift; tovön
light - (to ignite) = filidön
  - (not heavy) = leitik
  - (not dark) = klilik
lighter - filidöm
lightning - leklär
lighthouse - far, maletamatüm
like - (similar, same) = sümik, ot
  - (to like) = löfilön, plidön
  - (preposition) = äs
lilac - süren
lily of the valley - mügät
lime - tiliad (fruit); zem
limit - mied; miedükön
(to) limp - boatagolön
line - (fishing) = lefad
  - (written) = lien
    * on the lines of = prinsipü
linen - stofädem, linumastof, linumik
lining - furot
link - yumädalim
linoleum - linkrust
lion - leon
    * a sea lion = leonatoar
lip - lip
liquid - (liquid body) = flumot
  - (not solid) = flumöfik
liquorice - likvir, likvirod
list - lised; lisedön
(to) listen - dalilön
listener - dalilan
literary - literatavik
literature - literatav
litter - defal
little - nemödik, smalik, boso, nemödo
    * little by little = pianiko
(to) live - lifön, lödön
(to) live on (= without end) - lailifön
livelihood - kosid
liver - (anatomy) = foad
load - fled, lodot
(to) load - fledön, lodön
    * to load a gun = fledülön
lobster - humar
local - topik
locality - topam
(to) locate - pladön
    * to be located = topön
lock - klut (= nautical) lök (= in door)
(to) lock - färmükön löko, färmükön me lök
locomotive - lemüf
long - lunik
longer - lunikum
(to) long for - desirön, ledesirön
look - loged; logedön
  - (to look like) = logotön
look-out - selogam; galädöp (= building)
(to) loosen - livükön
lorry - fledatood, fledavab
(to) lose - perön
    * to lose the way = pölavegön
loss - per
  - (thing lost) = perot
    * lost = peperöl
lot - (destiny) = fät
  - (everything) = lemöd
  - (lottery chit) = loterazöt
loud - laodik
louse - puf
love - löf, lelöf; löfön, lelöfön
    * a loved one = löfäb
low - (not high) = lövik
    * lower (primary) school = donajul
(to) lower - donükön
loyal - ritöfik
loyalty - ritöf
(to) lubricate - leülön, smivön
luck - läb
lucky - läbik
luggage - päkem
    * Left Luggage Office = päkemikipedöp
    * luggage compartment = päköp
lukewarm - vamülik
lunch - koled; koledön
lung - lueg
(to) lust - rütön
luxurious - lüxüödik
luxury - lüxüöd
lying-place - seatöp
lymph (gland) - lümf

-------------------- M--------------------

machine - cin
mackerel - skomb
mad - lienetik
magic - magiv
magician - magivan
magnanimous - nobaladälik
magneto - magnet
magnitude - (maths) = greted
magnolia (tree) - magnol
mahogany - mahun
maiden - jipul, jivirgan, vomül
mail - pot; potön
main - cifa..., cifik
mainland - cifalän
mainly - ledino
mains (connection) - dugian
maize - mait
majestic - mayedik
majesty - mayed
major - mayor, gretikum
majority - (adulthood) = nentüt
  - (greater number) = pluamanum
(to) make - mekön
  - (to make up a bed) = leblimön
male - manik
mallow - maluv
man - (masculine) = man, himen
  - (people) = men, mens
  - (species) = menabidäd
(to) man (ship) - skipön
(to) manage - (to master) = bemastön
  - (to direct) = dilekön
  - (to lead) = dugön)
  - (to suceed) = plopön ad dunön
  - (to deal with) = träitön
manager - büsidacif, dilekan
mandolin - mandolin
manner(s) - (chivalry) = leplüt
  - (methods) = mods
  - (mores) = süds
manor (house) - lesiöradom
manufacture - fabrikam, fabrikot
(to) manufacture - fabrikön
manuscript - namapenäd
many - mödik
map - kaed
marble - maboin
march - malek; malekön
    * march in musical notation = maleküm
March - (month) = mäzul
margarine - margarin
mark - (currency) = mak
  - (emblem) = mäk; mäkön
  - (sign) = mal; malön
  - (schoolwork) = penet
    * good/bad mark = beopenet/mipenet
    * mark my words! = küpädolöd vödis oba!
marked - (observable) = küpidik
market - maket
marriage - mat
(to) marry - matükön (eki)
    * to get married = matikön (ko)
martyr - martüran
marvel - milag, stunidot; stunön
marvellous - milagik
marzipan - masapen
mass - (quantity of material) = masat
  - (religious ceremony) = mäsäd
  - (a great deal) = mödot
(to) massage - masetön, röbön
mast - (ship's) = maat
master - mastan; bemastön
masturbation - masturbat
mat (of straw) - stolajuged
match - (for striking) = lümät
  - (competition) = mät
    * to be a match for = plobön (pro)
matchless - (without equal) = neleigodovik
(to) mate - koitön (ko)
material - mater
matter - din, stöf
mattress - matrad
maximum - muikos
May - mayul
mayor - sifal
meadow - bälät, yebalän
meal - (general) = fidäd
  - (dinner) = fided
  - (flour) = meil
    * a meal time = fidüp
mean - (average) = zäned
  - (centre) = zänod
(to) mean - (opine) = cedön
  - (to intend) = diseinön
means - (income, salary) = lemesed
  - (by means of...) = medü...
  - means to an end) = medöm
meantime (in the) - vüo
measure - maf
(to) measure - mafön
meat - mit
mechanic - mufavan
medical - sanavik
    * medical man = sanan
medicine - (remedy) = medin, sanamed
  - (science) = sanav
mediore - zänedöfik
medlar (tree) - mäspil
(to) meet - kolkömön
meeting - (assembly) = kobükam
melody - melod
(to) melt - smetön, smeitön
member - lim, liman
membership - limanam
memory - mem
menagerie - nimikonlet
(to) mend - (patch up) = nägedön
  - (restore, heal) = nätükön
(to) mention - mäniotön
menu - fidädakad (= menu d'hote) zibalised (= à la carte)
merchant - tedan
merciful - miserik
merciless - nenmiserik
mercury - (substance) = märkurin
mercy - miser
mere - te
merit - meritab; meritön
merriment - lefred
merry - lefredik
merry-making - yof
message - nun
metal - metal
metallic - metalik
method - metod
metodical - metodavik, metodik
methodology - metodav
metric - metik
    * metric system = metöf
metrology - metöfav, metrigav
micrococcus - kök
midday - zedel
middle - zänod
midfield (football) - zefel
    * midfield player = zerönan
midnight - zeneit
midsummer - zehitüp
might - nämäd
mighty - nämädik
mild - fiböfik, sofik
mile - liöl
military - militik
milk - milig
    * milk shake = miligamigot
    * milkbar = miligasälun
(to) milk - tätön
mill - mül
miller - mülan
million - balion
millstone - mülaston
mind - (reason) = tikäl
  - (take to heart) = kälälön
  - (occupied with) = jäfikön me
  - (call to mind) = süvokön
mine - meinäd
miner - meinan
mineral - minik
    * mineral water = minavat
minimum - nemuikos
mining - meinav
miniskirt - brefajuüp
minister - (politics) = ministeran
  - (religion) = pastan
Ministry (government department) - minister
minority - nepluamanum
mint - mänt (= plant ); mint (= money)
(to) mint (money) - frapön
miracle - milag
    * a miracle worker = milagidunan
mirror - lok; lokön
    * a mirror image = lokamamagod
(to) misbehave - mikondötön
misbehaviour - mikondöt
mischief (a little child) - put
mischievousness - badöfil
miserable - miserabik
misgivings - dod
(to) mispronounce - mipronön
(to) miss - (not hit) = nedrefön
miss - lädül, vomül
mist - fog
    * evening mist = soaravoal
mistake - (oversight) = pök; pökön
  - (error) = pöl; pölön
    * to mistake for = pölacedön (äs)
mistress - jimastan
(to) mix - migön
    * to mix up together = pemükön
mixed - pemigöl
mixer - (food) = migöm
mixture - migot
mockingly - lukofo
model - pated, samot
moderate - tämik; tämükön
moderation - täm
modern - nulädik, nutimik
modest - neflagiälik, pülik
modesty - neflagiäl
moist - luimöfik
molasses - melat
mole - (animal) = talp
moment - pülatimil, timül
Monday - mudel
money - mon
monk - hikleudan
monkey - lep
monopoly - monopul
monster - most
monstrous - mostöfik
month - mul
monthly - almulik
monument - mebamal
mood - vim
    * good/bad mood = benovim/mivim
moon - mun
    * full moon = fulamun
moral - südöfik
morality - südöf
more - plu
    * more and more = ai plu
    * more or less = pluuneplu
(the) more ... (the more) - plü ... plü
morose - favik, skanik
morosely - faviko, skano
moreover - zuo
morning - göd
morrow - odel
morsel - daifotil
mosquito - muskit
moss - musk
mostly - mödadilo
mother - jipal, mot
motion - muf
    * to motion by hand = vinegön
motionless - nenmufik
moth - neitapab
    * clothes moth = tarm
motor - motor, mufükian; vabön
motorbike - motorasaikul
motorway - toodaleveg
motto - devid
mountain - bel
(to) mourn (s.o.) - belügön (eki)
mouse - mug
moustache - bafod, mustag
mouth - mud
    * mouth of river = seflum
(to) move - (state) = mufön
  - (budge) = müfön
  - (move house) = fealotedön
movement - muf
(to) mow - fodön
Mr. - Söl
Mrs. - Läd
much - mödo, mödik
mud - släm
muddy - slämik
mule - mulud
multiplication - naedot
(to) multiply - (maths) = naedön
(to) mumble - murülön, stötön
murder - sasen; sasenön
murderer - sasenan
murderous - sasenik
muscle - muskul
museum - mused
mushroom - garid
    * fungus = funig
music - musig
    * musical instrument = musigöm
musician - musigan
mussel - koananim, müul
mustard - mutar
mutual - rezipik, kobädik
mutton - hojipamit
mysterious - müsterik, klänöfik

-------------------- N--------------------

nail - nail, kluf; klufön
    * fingernail = nuel
naked - nüdik
name - nem; nemön
napkin - särvät
narcissus - narzid
narrow - (tight) = nabik
  - (roads, lanes) = rovik
  - (thinness) = rovik
nation - net
national - netik
native - (born and bred) = länan, lomänan
  - (native land) motedalän
    * patriot = lomänälan
natural - natik, natöfik
naturalist - nativestigan
nature - nat, natäl
nausea - tufav
navel - numbril
navy - (fleet) = nafem
  - (colour) = maren
near - nilo, nilü
neat - klinik, plitülik
nebula - silefog
necessary - zusüdik
necessity - zesüd
neck - nük, särvig
neckerchief - tanod
need - neodot; nedön, neodön
needle - nad
needlework - namavob (vomik)
(to) neglect - nefölön, nekälön
neglicence - nekäl
negligible - neledamabik
neighbour - nilädan
neighbouring - nilädik
neither ... nor - ni ... ni
nephew - hinef
nerve - nev
    * nerve system = nevasitot
nervous - närvodik
nest - näst; nästön
(to) nestle - nästülön (len)
net - filät
    * take with a net = fanön me filät
network - filäts, resod
neutered - penegenüköl
never - neai, neföro, nonikna
nevertheless - too
new - nulik
news - nulods, nuns
newspaper - delagased
newt - salmun
next - mu nilü
    * next coming = okömöl
    * next week = ovigo
    * next to each other = bal len votik
nice - (good-looking) = jönik
  - (disposition) = plitälik
  - (neat, smart) = plitülik
niece - jinef
night - neit
nightingale - reitak
nine - zül
(to) nip - knibön
no! - (denial) = nö!
no longer - no fovo, no plu
nobility - noub
noble - (worthy) = nobik
  - (aristocracy) = noubik
nobleman - nouban
nod (of the head) - nut
(to) nod one's head (in agreement) - nutön
noise - lenoid
nonsense - nesiäm
none - nonik
noodle - pested
noon - zedel
nor: neither ... nor - ni ... ni
normal - nomik
north - nolüd
northern - nolüdik
nose - nud
not - no
    * not even = igo no...
    * not at all = leno
    * not yet = no nog
notary - notaran
note - (musical) = noat
  - ((short) note) = penet, penetil
  - (counterfoil) = zöt
    * a short letter= penedil
    * to take note = penetön
notebook - päm
notice - (information) = nun
  - (warning) = nuned
  - (note) = penet
notion - suemod
novel - lekoned
novelist - lautan lekonedas
novelty - nulod
November - novul
now - nu
    * nowadays
    * now and then = semikna
nowhere - neseimo
nucleus - püt
nude (model) - nudädan
number - (quantity) = num
  - (in series) = nüm
numerate - nümädik
numerous - modik
numismatics - könädav
nun - jikleudan
nurse - (nursery nurse) = cilijikälan
  - (in hospital) = jikälan
  - (wet nurse) = sügan
(to) nurse - kälön
nursery - (plants) = planidabridöp
  - (infants) = putacem
nut - nöt
nutmeg - muskat

-------------------- O--------------------

oatmeal - grot
oats - vaen
obedient - lobedik
(to) obey - lobedön
object - (thing) = yeg
  - (to object) = taspikülön, taön (ta)
objection - taspikül
(to) oblige - bligön
oblong - lunädik
observance - küped
observation - küpedot
observatory - küpedöp
(to) observe - küpedön
observer - küpedan
obstinate - fümädik
(to) obtain - dagetön
obviously - kleiliko
occasion - pöt
occasional - semiknaik
occupant - beseidan
occupation - (in occupation) = beseid, bepladam
  - (profession) = cal
(to) occupy - beseidön, bepladön
(to) occur - jenön
occurrence - jenot
ocean - sean
October - tobul
octopus - polüd
odd - neteldilovik
of - de
off - de
offence - nof, skän
(to) offend - nofön, skänön
offender - nofan
offensive - skänik, tatakalebit
offer - lofot; lofön
office - (room) = bür, büröp
  - (position) = cal
officer - (military) = fizir
official - calan, calöfik
officious - ticalöfik
often - suvo
oh! - o !
oil - leül; leülön
    * an oil and viinegar set = leülevinigalöläd
    * hair oil = pin
ointment - nugvet
old - (age) = bäldik
  - (not fresh) = neflifedik
  - (old) = vönedik
  - (ancient) = vönik
old-fashioned - vönädavogädik
omelette - moelät
omission - nedun
(to) omit - nedunön, seletön
on - su
    * on top of = löpü
once - (one time) = balna
one - (numeral) = bal
  - (s.o.) = balan, ek
  - (pronoun) = oy
onion - beb
only - (sole) = balik
  - (mere) = te
    * only now = pas
onslaught - tutatak
open - maifik; maifükön
opening - maifod
operation - kötet (surgical); tölat (general)
opium - mäkun
opinion - ced
opportune - pötik
opportunity - pöt gönik
(to) oppose - tadunün, taön, tapladön
opposite - (facing) = kos
  - (contrary) = taik
(to) oppress - sumätükön
optician - lünavan
or - u, ud, ü, üd
    * either ... or = u ... u; ü ... ü
oracle - roag
orange - (colour) = rojanik
  - (fruit) = rojat
oration - spikäd
orbit - zümuf
order - (command) = büd; büdön
  - (subscription) = boned; bonedön
  - (arrangement) = leod; leodön
ordinary - (usual) = geböfik
  - (common) = komunik
  - (customary) = kösömik
ore - mün
    * iron ore = ferinamün
organ - (animal/plant) = jäfidäm
  - (human) part) = jäfidan
  - (journal), etc.) = jäfidot
  - (musical instrument) = gel
organic - jäfidämik
organism - nogan
organist - gelan
(to) organize - noganükön
orgasm - sömitamapün
origin - rig
original - rigädik, rigik
(to) originate - davedön, davedükön
other - votik
out - de, dese, se
outburst - rupäd, splodül
outcast - deimäb
outer - plödik
outline - skät; skätön
outside - plödo
    * an outsider = foginan
outspread - stäänik
outstretched - petenüköl
oven - furnod
over - love, sus
    * over there = usio
overbalance - pluvät; dofalön
overcast - (weather) = lefogik
overcoat - plögun, plömäned
(to) overcome - bemastikön
overdue - tulatik
overenthusiasm - tuzil
(to) overexert - tutöbidön
overflow - loveflum, tuvatam; loveflumön, tuvatön
(to) overlook - neküpön
overpopulated - tupöpagik
overproduction - tujafäd
(to) overrate - tudigidön
(to) overshadow - lovejadön
overstatement - tuükam
(to) overstate - tuükön
(to) overstrain - tutöbidön
(to) overtake - reivön
overture (music) - primüm
(to) owe - (money) = debetön
  - (someone something) = debön (eke bosi)
owl - lül
own - (one's) = lönik; dalabön
owner - dalaban
ox - hobub
oxygen - loxin
oyster - hüit

-------------------- P--------------------

pack - päk
(to) pack - päkön
page - pad
pain - dol
(to) pain (= hurt) - dolön
painful - dolik
paint - kölam
(to) paint - kölön
    * to paint on canvas = pänön
painter - (house) = kölan
  - (artist) = pänan
painting - pänot
pair - pär; pärükön
palace - ledom, regadom
pale - paelik; paelikön
palm - (of hand) = namakev
  - (tree) = pam
palmistry - namabüosag
pan - paäl
pancake - paänakek
pancreas (gland) - pankreat
panel - fremül
panties - niblit
pantry - viktualacem
pants - niblit
paper - (newspaper) = delagased
  - (ordinary) = papür
  - (wallpaper) = tapot
(to) paper - (wallpaper) = tapön
papyrus - papürod
parachute - falajelöm
paraffin - parafin
parallel - fagotaleigik
paralysis - lem
parasite - parasit
parcel - (ordinary) = päked
  - (small) = päkedil, päkil
pardon - pard, säkusad; pardön, säkusadön
parent(s) - pal(s)
park - legad, parköp (= for vehicles)
parliament - dail
parlour - lomöfacem
parrot - papag
parsley - pärjid
part - dil, dilot; dilön
    * part in a play = roul
particular - patik
parting (of hair) - heremiteil
partition - kiud
partly - dilo
partridge - pädrit
party - (faction) = palet
(to) pass - beigolön, beivegön
passenger - tävan
passer-by - beian
Passion (of Christ) - Lügadramat
passport - dientifäd, tävapäs
past - (time) = paset, pasetik
patent (shoes) - laigaküir
path - luveg
patio - gadapiadil
patient - (person) = malädan
  - (long-suffering) = sufädik
patriotism - lomänäl
patrol - patrul
pause - paud; paudön
(to) pave - pavön
    * to pave the way = kulön vegi
pavement - pavot, pärunaveg
paw - (of animal) = lufut
(to) pawn - panön
(to) pay - pelön
payment - pel, pelam
pea - pisäl
peace - püd
pear - bün
pearl - pärlat
    * mother-of-pearl = nakar
peasant - feilan
peculiar - patik
peculiarity - pat
pedal - tridöm
(to) pedal - tridön
peddler - kolportan
pedestrian - futogolan
peel - säjalam
(to) peel - säjalön
peep-hole - logedahog
pelican - pelek
pen - pen
pence - pänid(s)
pencil - stib
peninsula - tinisul
penniless - nenmonik
penguin - pinguen
people - (persons) = mens
  - (one) = oy
  - (community) = pöp
pepper - kapsig (= Spanish pepper plant); pep (= general)
(to) perceive - küpön, sienön
per cent - dötum
percentage - dötumanum
perception - küp, sienam
perch - bemül
perfect - nedöfik, nendöfik
(to) perforate - hogön
(to) perform - (to do) = dunön
  - (achieve) = ledunön
  - (present) = plösenön
performance - (theatre, etc.) = plösen
performer - plösenan, roulan
perfume - benosmelot
perhaps - ba
period - period
periodical - gased, timapenäd, periodik
permanent - laidik
permanently - laidiko, laidio
permission - däl
(to) permit - dälön, leadön
(to) persecute - pöjutön
person - pösod
personal - pösodik
(to) persuade - süadükön
persuasion - süad, süadükam
petal - petiol
petrol - bänsin
    * petrol tank = bänsinacub
    * petrol consumption = bänsinifegeb
(to be) petty (about) = demilön (dö)
petroleum - petrol
petticoat - nijuüp
pharmacist - pötekan
photograph - fotografot
photographer - fotografan
photography - fotograf
physical - kopik
    * physical training = koapaskilükam, turav
physics - füsüdav
pianist - pianodan
piano - pianod
    * a grand piano = göbapianod
(to) pick - (pluck) = plökön
  - (pick up) = lasumön
    * (rich) pickings = pisälabemül
pickaxe - tipotacop
picnic - pignig
(to) picnic - pignigön
picture - (illustration) = magod
  - (painting) = pänot
  - (portrait) = pöträt
pie - (pastry) = bastet
  - (fruit pie) = flukatoed
piece - balat, kötot
pier - melapon
pig - svin
pigeon - pijun
pike - (fish) = paik
pill (medication, in strip) - (tanoteda)pilul
pillow - kapakusen, bedakusen
pin - peän; peänön
(to) pinch - knibön
pine (tree) - pein
pincer(s) - zäp
pink - (flower) = diant
  - (colour) = redülik
pipe - (tobacco) = pip
  - (water, etc.) = rüd
pirate - melaravan, piratan
pity - pid; pidön
place - plad, top; pladön, topön
plaice - (fish) = veitafit
plain - (location) = plen, kamalän
  - (level) = plenöfik
  - (clear) = kleilik
  - (smooth) = smudik
plan - (intention) = desin; desinön
  - (aim) = disein; diseinön
  - (sketch) = disin; disinön
'plane - (aeroplane) = flitöm
plant - plan; planön
plaster (to cover wound) - mäplat
plastic - plastätik
plate - boved
platform - (railway) = xänakäv
play - pled; pledön
pleasant - blesirik
please! - begö!
(to) please - plitön
pleasure - blesir, yof; yofön
    * a pleasure yacht = blesirayakt
pleated - plifädik
plenty - bundan, bundanik
    * in plenty = bundano
pliers - zäp
plough - plaud: plaudön
  - (constellation) = sigretaber
ploughman - plaudan
plug - buon (= for sink); kontagabuonäd (= electrical)
plum - plöm
(to) plunder - beravön
(to) plunge - blunön
plush - trib
pocket - pok; pokön
poem - poedot
poetic - poedik
poetry - poedav
point - (dot) = pün
  - (sharp end) = tipot
  - (point of view) = leced
pointed - tipik
poison - venen; venenön
poisonous - venenik
poker - (for fire) = lefilahuk
pole - staf
    * pole vault = bunstafabunam
police - (force) = poldanef
policeman - poldan
police station - poldabür
(to) polish - lekluinön, smufetön
polite - plütik
politeness - plüt
political - bolitik
politics - bolit
(to) pollute - miotükön
pollution - miotükam
polyp - polip
polyphony (music) - mödavög
polytheism - mödagod
pomp - lumagif
pond - lulak
pool - fiv
    * swimming pool = svimöp
poor - pöfik
poppy - pop
popular - pöpedik, pöpätik
poplar (tree) - plop
popularity - pöped, pöpät
(to) populate - pöpön
population - pöp
populous - pöpagik
porcelain - bösin
pork - svinamit
port - (seaport) = pof
porter - päkemipolan
portion - dilod
portly - klöpöfik
(to) pose in the nude - nudädön
position - (in society) = sogät
  - (general) = stad
positive - (electrical) = positik
  - (optimistic) = siik
positively - siämo
(to) possess - dalabön
possible - mögik
possibly - bo
post - (workplace) = bür
  - (job) = cal, calül
  - (mail) = pot; potön
postage - potamon
postcard - potakad
postman - penediblinan
post office - potöp
pot - skal
potato - pötet
pound - paun
(to) pour - (cast) = gifön
  - (drinks) = nügifön
  - (rain etc.) = stürön
  - (pour out emotions) = sestürön
(to) pout - prulön
poverty - pöf
powder - (gunpowder) = pur
  - (toiletry) = puin
power - nämäd, lektinanäm (= electrical)
(to be) practicable - pötöfön
practical - plagik, pötöfik
practice - (acquiring skills) = okskilükam
  - (actually doing) = plag
  - (not theory) = pläg
(to) practise - plagön, plägön
(to) praise - lelobön
praiseworthy - lelobabik
(to) prattle - kagön
(to) pray - plekön
(to) preach - predön
preacher - predan
(to) precede - befoön, fogolön
precinct - (pedestrian) = futagolanazon
precious - jeragik
precipice - kliv
predecessor - fogolan
(to) prefer - buön, buükön
preferably - buikumo, buo
pregnant - grodik
prejudice - bücödot, bümicödot; bücödön
(to) prejudice - bümicödön
(to) prepare - mökön, preparön
preparation (medical) - mökot
prescription - rezäp
(in) presence (of) - lo
present - (gift) = legivot; legivön, lofön
  - (place) = komik
  - (time) = presenik
(to) present - plösenön
(to) preserve - kipedön
(to) preside - presidön
presidency - presidanam
president - presidan
press - (news media) = gasedem
  - (to apply pressure) = pedön
pressure - ped
    * air pressure = lutaped
prestige - prästig
presumably - niludo
(to) presume - büocedön, niludön
presumption - nilud
pretence - cedid
(to) pretend - (feign) = cedidön
pretension - rog
pretentious - rogik
pretext - kodül
pretty - plitülik
(to) prevent - büoneletön, neletön, taedön
prevention - büonelet, nelet
previous - büik
previously - büo, büiko
price - suäm; premädön
priest - (catholic) = pädan
  - (evangelical) = pastan
  - (general) = kultan
priesthood - kultanam
prince - plin, leson
    * Crown Prince = geraleson
princess - jiplin, ledaut
principal - cif, cifa..., cifik
principality - plinän
principle - prinsip
print - bük; litod (= photos)
(to) print - bükön; litodön (= photos)
printer (computer) - dabüköm
prison - fanäböp
prisoner - fanäböpäb
privacy - soelöf
private - (confidential) = konfidik
  - (restricted) = privatik
prize - prem
probable - luveratik
probably - bo, luveratiko
problem - säkäd
problematical - säkädik
procedure - bit
(to) proceed - progedön, biton (äs)
proceedings - nunod(s)
(to) procrastinate - nefümälön
produce - prod, cans
    * colonial produce = kolunänacans
(to) produce - prodön
product - fabrikot, jäfüd, prod, prodäd
production - prodam
(to) profess - (work) = cal
  - (faith) = lekoef
professional - calik
  - (person) = jäfüdan
professor - profäsoran
profit(s) - frut, gaenät, gaenod
    * to profit by = gaenätön dub, se
profitable - frutik
profitably - fruto
programme - program
progress - proged; progedön
progression - proged
progressive - progedöfik
promise - prom; promön
prompt - blümik, vifik
(to) pronounce - pronön
pronunciation - pron
proof - blöf
proper - (fitting) = gidöfik
  - (one's one) = lönik
  - (straightforward) = voik
properly - gidöfiko, voiko
property - (possession) = dalabot
  - (quality) = patöf, ledutod
proportion - propor
    * in proportion = maä (+ verb)
proposal - mob
(to) propose - (suggest) = mobön
prostitute - jinepuedan
(to) protect - jelön
protection - jel
protective - jelöfik
protector - jelan
protegée - jijeläb
protest - protest; protestön
protestant - (person(s)) = protästan(s)
proud - pleidik
(to) prove - (give proof) = blöfön
  - (try out) = blufön
(to) provide - blümükön, blünön (= deliver); jonidükön
    * to provide with = labükön
providence - büologam
provision(s) - fidastok, viktualastok
provisional - büfik
prow (of ship) - föfastev
(to) prune - (trees) = kötülön
pub - (house) = bötädöp
public - notidik, notik
public - (audience) = lüloganef
  - (general) = publüg
publicity - reklam
to) publish - dabükön
publisher - dabükan
(to) pull - tirön
to pull out = setirädön
    * to pull up = lötirön
pulse (medical) - peb; pebön
pulsar - pebastel
pump - pömöm; pömön
    * to pump up (inflate) = fuliopömön, nübladön
pumpkin - zukad
punch - pöjin (= an alcoholic drink)
(to) punch - daflapön
(to) punish - pönön
punishment - pön
pupil - julan, lärnan, tidäb
purchase - rem; remön
pure - klinik (= general); rafinik (= of metals)
(to) purify - rafinükön
purple - purpurik
purpose - desin
    * on purpose = desino
purse - böb
purser - pelal
(to) pursue - pöjutön
pus (medical) - purul
push - jok
(to) push - joikön
    * to push back (= out of the way) = pleifön
(to) put - pladön, seitön
puzzle - lerät; bluvükön
    * it puzzles me = atos bluvükon obi
puzzled - bluvik
(to be) puzzled - bluvön (dub)
    * I'm puzzled by it = binob bluvik, bluvob dub atos
puzzling - bluvüköl
    * a puzzling question = säkäd bluvüköl

-------------------- Q--------------------

quail - kotur
quality - kaliet
quantity - mödot
quantum (theory) - kvant
quark (physics) - nenvöladet
quarrel - zan
(to) quarrel - zanön
quarrelsome - zaniälik
quarter - (of an hour) = düpafoldil
  - (fraction) = foldil
  - (of a city) = harat
quasar - zastelikos
queen - jireg
queer - bisarik
    * (slang for) homosexual = otgeniälik
question - säk; säkön
quick - vifik
quiet - stilik, takedik
    * to be quiet (say nothing) = takedön
quintal (100 kg) - kuin
(to) quibble - blamilön
quite - löliko, go
(to be) quits (money) - leigetön
quotation - (price, market) = maledot
  - (from document) = saitot
(to) quote - (price, market) = maledön
  - (from document) = saitön

-------------------- R--------------------

rabbit - krolig
race - (breed) = bidäd
  - (competition) = mätarön; mätarönön
rack (for towels, etc) - kipian
racket (tennis) - räkät
radar - radar
radiator (car) - koldülüköm
radio - radion
radish - raf
(to) rage - vutön
rail - ferod
railway - ferodarutaveg, trenaveg
rain - rein; reinön
rainbow - reinabob
raincoat - reinamäned
(to) raise - tovön
raising (impromptu) - süpalöükam
rampart - daemod
random - nenzeilo
    * at random = ma fäd
range - mögov, portat
rank - dinit, ledinit, gredät
rapid - vifik
rapidity - vif
rapier - den
rare - seledik, plödakösömik
rarely - selediko, plödakösömiko
raspberry - frambod
    * a raspberry bush = frambodarubud
rat - rat
    * (the) rat race = marat
rate - mafäd, propor, suäm
    * rate of exchange = cänakursüd
rather - ze, buikumo
(to) ratify - lonön
rational - tikälik
rattle - krot
rattlesnake - krotasnek, noidülasnek
raw - (rough) = grobik
  - (uncooked) = krüdik
  - (coarse) = raodik
ray - stral
razor - jeiföm
razor-blade - jeifalam
(to) reach - rivön
reach - portat
(to) react - geükön
(to) read - reidön
(to) read out - loreidön
reading (passage) - reided
ready - blümik
    * ready to wear = konfäkot
real - jenöfik
reason - (cause) = kod
  - (reason) = täläkt
  - (mind) = tikäl
(to) reason - datikön, meditön
reasonable - täläktik
(to) reassure - lesiön dünu, lekredükön
receipt - (document) = kitazöt
(to) receive - getön
recent - de tim lätik, brefabüik
recently - enu, bü brefüp
receptionist - getedan
recess - nik
(to) recite - komoreidön
(to) recognize - dasevön, memosevön
(to) recollect - memön
recollection - (in remembrance) = meb
  - (to remember) = mem
(to) recommend - komandön
recommendation - komand
(to) reconcile - balädükön
record - (disc) = tonodasirkot
  - (LP) = mikrodagrufasirkot
recorder - (musical instrument) = blögaflut
  - (tape recorder) = tonodisumodöm
  - (video recorder) = magodisumodöm
record player - tonodisumodöm
(to) have recourse (to) - yufidön
(to) recover - (cover again) = dönutegön
  - (be restored to health) = saunikön
recovery - saunikam
red - redik
red-indian - redaskinan
(to) reduce - läsükön, nemödükön
reduction - läsükam, nemödükam
reef (coral) - korialaref
(to) refer - jonön, tefön
reference - jon, tef
(to) reflect - (light) = fläkön
reflection - (light) = fläk
refrain (music) - dönuod
(to) refresh - (eat) = staudön
  - (freshen up) = flifädükön, klietön
refreshing - klietik
refreshment - flifädükam, staud
    * refreshments = klietots
refreshment room - staudalecem
refrigerator - gladaramar, koldülüköm
refuge (from traffic) - sütasefädöp
refusal - klem, refud
(to) refuse - klemön, refudön
(to) regain - dagetön dönu, rivön dönu, gegaenön
regard - (refer to) = dem; demön
  - (high regard) = lestüm; lestümön
  - (glance) = loged; logedön
regatta - regat
regret - pid; pidön
regrettable - pidabik
regular - nomädik, nomik
regularly - nomiko
rehearsal - lepläg
reindeer - ren
    * reindeer skin = renaküir
(to) reject - deimön
(to) rejoice - fredön, yöbön
(to) relate - (story) = konön
relation - hi/jiröletan
(to) release - (set free) = libükön
  - (let go) = livükön
  - (release spring) = süükön
relevance - demäd
reliability - konfidov
reliable - konfidovik
reliance - konfid
relief - (from weight) = leitükam
(to) relieve - leitükön
religion - rel
religious - relöfik
(to) rely - lekonfidön
(to) remain - (stay) = blebön, bleibön , blibön
  - (lasting) = laidön
  - (be left over) = retön
remainder - (left over) = ret
remark - (observation) = küpet; küpetön
  - (in text) = noet
  - (annotation) = penet; penetön
remarkable - küpädik
remedey - tamed
(to) remember - memön
(to) remind - mebön
reminder - meib
(to) remove - moükön
renaming - votanemükam
render - (return) = gegiv; gegivön
  - (transmit) = lovegiv; lovegivön
(to) renew - nulükön
rent - loatamon; loatön
(to) repair - nätükön
(to) repay - bläfön (= good for bad )
  - gepelön (= money)
repeat - dönuam; dönuön
repeatedly - dönuamo
(to) repent - lepidön
repentance - lepid
repertoire - duinavotem
repetition - dönuam
(to) replace - plaädön
reply - begesag, gespik
(to) reply - begesagön, gespikön, geön
report - (account) = nunod; nunodön
reporter - nunodan
(to) represent - (graphically) = magön
  - (in person) = pladulön
representation - mag
representative - (adjective) = pladulik
  - (personal) = komulan, pladulan
reprimand - leblam; leblamön
reproach - riprod; riprodön (eke bosi)
(to) reproduce - söjafädön
reproduction - söjafädot
republic - repüblikän
republican - repüblikänan
(to) repulse - gejoikön
reputation - benorepüt
repute - repüt; pacedön
    * he is reputed to be rich = pacedom ad binön liegik
request - beg; begön
    * a begging letter = begapenäd
    * an official request = fomülam
(to) require - flagedön, flagön (eke bosi)
research - vestig; vestigön
(to) resemble - leigön, sümön
reservation - ,(condition) = büdakip
reserve - resärf; resärfön
reserved - (have low profile) = nenotodälik
(to) resign - (quit) = klemön, sädünikön
  - (to resign oneself) = sufedön
resignation - klem, sädünikam
resigned - klemöl, klemölo
(to) resist - tadunön
resistance - tadun
resistant - sufidik
resolute - fümälik
resolution - fümäl, slud
resolve - slud; sludön (ad)
resort (seaside) - banatop
respect - (reference) = tef; tefön
  - (esteem) = stüm; stümön
responsible - gididik
rest - (remainder) = ret; retön
  - (repose) = takäd; takädön
restaurant - staudöp
restoration - (repair) = nätükam
  - (health) = saunükam
(to) restore - (repair) = nätükön
  - (health) = saunükön
restraint - täm
(to) restrict - miedükön
restriction - miedükam
result - sek; sekön
(to) retain - dakipön
(to) retire - (depart) = gegolädön
  - (work) = necalikön
  - (from society) = soalükön oki
retirement - necalikam, oksoalükam
(to) retrace - (one's step) = gestepön (lü)
retrorocket - geraket
(to) return - (give back) = gegivön
  - (go back) = gegolön
  - (action) = geikön
(to) reveal - sävilupön
revenge - vindit; vinditön (eke me)
reverse (edge) - bäkasiem
review - (publication) = gased
  - (book, etc.) = krüt; krütön
  - (parade) = päräd; pärädön
(to) revise - revidön
(to) revive - dönulifükön
revolt - volut; volutön
revolution - levolut; levolutükön
revolutionary - (adjective) = levolutik
  - (adherent) = levolutan
(to) revolve - tülön, tulön
reward - belegivön (= with a gift); mesed; mesedön
rhododendron - rododen
rhythm - ritmut
rib - (anatomy) = rib
ribbon - tanod
rice - risat
ricefield - risataläned
rich - liegik
(to) get rid of something - nelabükön bosi
riddance - sälabükam
    * Good riddance! = Sälabükam gudik!
ride - monit; monitön
ridiculous - smilöfik, ledrolik
right - (not left) = detik
  - (in the right) = gidetön
  - (decent, just) = gidik, gidöfik
  - (just claim) = gität
  - (not wrong) = verätik
    * an inside right (football) = nidetatatakan
rigid - stifik
ring - (bell) = toen; toenön
  - (general) = ton; tonön
  - (on finger) = lin
  - (circle) = sirkül; sirkülön
ripe - madik
(to) ripen - madikön
(to) ripple - mürön
(to) rise - (from bed, chair) = löädön (se)
  - (to give rise to) = süükön
risk - riskäd; riskön
risky - riskädik, riskodik
river - flumed
road - veg
roar - ror; rorön
roast - loet, loetamit
    * a roast goose = ganaloet
(to) roast - loetön
(to) rob - beravön, ravön
robot - mäikamen
robber - ravan
robbery - rav
rock - klif
(to) rock - klädön, kledön
rocket - raket
rocky - klifik
rod - staf
    * rod iron = stafafer
roll - (rolled up) = ruläd
  - (cylinder) = zilid
(to) roll - rolön, rölön
    * bread roll = bodedül, bodül
roof - nuf; nufön
room - (of house) = cem
  - (space) = spad
root - vul; vulikön, vulön
  - (to be rooted) = süstegön
rope - jain
rose - rosad, rosadaredik
rosy - rosadaredik
rot - puridikam
    * to become rotten = puridikön
    * to make rotten = puridükön
    * rotten = puridik
rough - groböfik, raodik
round - klöpik
row - (line) = ked
(to) row - gubön
rowan (tree) - sorbabim
rower - guban
rowing-boat - gubabot
royal - regik
royalty - regam
(to) rub - röbön, röülön
  - (to rub on) = smivön
rubber - (India-rubber) = gum
  - (eraser) = güm, radagüm
rubbish - debreijot, failot(s), gagot
rubric - rubrig
rude - grobik, grobälik, neplütik
rudeness - grob, grobäl, neplüt
ruin - bumädafailot, failot(s)
(to) ruin - nosükön, päridükön
ruinous - failabik, päridüköl
rule - (regulation= = nom; nomükön
(to) rule - (master) = mastön
rum - rom
rumour - (gossip) = sagäd
    * it is rumoured, that... = sagoy, das...
(to) run - rönön, vifagolön
ruse - käfod
rush - juted, tatak; jutedön, tatakön
rusty - ruilik
rye - sägul

-------------------- S--------------------

sabotage - sabot
sack - sak
sad - lügik
saddle - säed
sadness - lüg
safe - sefik
safety - sef
safety-pin - sefanad
sage - (herb) = salb
sail - sail; sailön
sailor - melan
saint - hi/jisaludan
sake - dem
    * for the sake of = demü
salad - salad
salamander - salmun
salary - mesed, lemesed
sale - sel
salmon - salm
salt - sal
    * a salt and vinegar set = salevinigalöläd
    * an oil and vinegar set = leülevinigalöläd
salty - salöfik
same - ot
    * just the same = ebo ot
sample - samed
sand - sab
sarcasm - sarkad
satellite - munäd
satire - satir
satisfied - pekotenüköl
(to) satisfy - kotenükön
Saturday - zädel
sauce - sod
saucer - disbovedil
saucepan - sosit
sauna - saunad
sausage - sosit
    * sausage roll = sositaruläd
savage - (cruel) = kruälik
  - (wild) = sovadik
(to) save - (rescue) = savön
(to) save up - spälön
saw - saov
(to) saw - saovön
sawdust - saovät
saxophone - saxofon
(to) say (s.th. to s.o.) - sagön (eke bosi)
scaffold - skafod
scale(s) - (measure) = gredaked
  - (of fish) = tegül(s)
  - (machine) = vätöm
scalp - skalp
scar - skar
(to) scar - skarükön
scarce - nebundanik, seledik, töbo saidik
scarcely - töbo
scarcity - def
(to) scare - jeikön
(to) scatter - jedülön, sestürülön
(to be) scattered (with) - bestürülön (me)
scene - (theatrical) = süfül
scenery - (theatre) = teatam
scent - benosmelot
sceptical - dotimik
scholastic - skolik
school - jul
science - natav, nolav
scientific - natavik, nolavik
scientist - nolavan
scissors - (pair of) = jim
scoundrel - kanayan
scout - boskotan
(to) scrape - kratön
scratch - krat; kratön
scream - luvokäd; luvokädön
screen - (partition) = jelöm
  - (cinema, TV) = jonet
screw - skrub
(to) screw - skrubön
screwdriver - skrubitulöm, skruböm
scrotum - skrot
scurvy - skorbut
scythe - fod; fodön
sea - mel
seagull - möv
seal - fuk, meladog , rob
    * elephant seal = makrorin
sealion - leonatoar
seamstress - jinägan
seaport - melapof
search - vestig; vestigön
searchlight - litijedian
seasickness - melamaläd
season - (of year) = säsun
seat - (bench) = bam
  - (place) = plad
  - (bus, train) = seadöp
  - (chair) = stul
(to) seat (o.s.) - seidön (oki)
    * Sit by me! = Seidolös oli lä ob!
seated - seadik
seating - sead
seaweed - laleg
second - (time) = sekun
  - (number) = telid
  - (person) = telidan
(to) second - stütön, yufön
secrecy - klänäd
secret - klänik
(to) secrete - skretön
secure - neriskodik, sefik; sefükön
security - neriskod, sef
(to) see - logön
seed - sid; sidön
seemly - gidöfik
seesaw - kledöm
(to) seize - gleipön
seizure - gleip, gleipäd
seldom - selediko, seledo
(to) select - (pick out) = sesukön
  - (choose) = välön
selection - sesuk, sesukot, väl, välid, välot
self - it, ok
self-confidence - saidäl
self-conscious - oksevedik
self-control - okreig
self-denial - oknoäd
self-interest - lönafrutäl
(to) sell - selön
(to) send - sedön
    * to send back = gesedön
sender - desedan
sensation - sen, stunükam
sense - (feeling) = sen
  - (good/bad sense) = siäm
  - (one of five) = sien
  - (meaning) = sinif
  - (to come to one's senses) = sevälöfikön
sensible - siämöfik
sensitive - senöfik
sentence - (judicial) = cödet, cödot; cödetön (eki ad)
  - (group of words) = set
separate - livik
(to) separate (from) - ditön (de)
separation - dit, teil
September - setul
series - sökod
serious - fefik
sermon - pred
servant - dünan, loatäb (= hired)
(to) serve - (meals) = bötön
  - (people) = dünetön, dünön
  - (God) = kultön
  - (in certain capacity) = bitikön (äs)
service - dünot, kult, kultipläg (= religious)
set - (collection) = konlet
  - (team) = kvip
  - (whole) = löläd
    * to set down = seidön
(to) settle - (colonize) = kolunön
  - (settle down) = lomädikön (oki)
settled (weather) - dulöfik
settlement - kolun, kolunän
settler - kolunan
seven - vel
several - ömik, mödikum
severe - sevärik
severity - sevär
to) sew - nägön
    * sewing machine = nägacin
sex - gen
shade - jad; jadön
shadow - jad
shady - jadaliegik
shaft - stag
(to) shake - lemufükön
shallot - jalot
shallows - nedibäd
shame - jem; jemön
shampoo - jämpod
shape - fom; fomön
share - dilod; dilodön
shark - jak
sharp - (keen edge) = japik
(to) sharpen - japükön
shave - jeif; jeifön
she - of
sheep - jip
sheepish - stupädik
sheet - (bedlinen) = bedastofed
  - (of paper) = blog
shelf - (for books) = bukaboed
shell - (husk/peel) = jal
  - (conch/shea-shell) = koan
  - (legume, pod) = ligum
shellfish - koanaf
shelter - (garret) = disnufamaludom
    * to find somewhere to stay = disnufön (oki)
asylum = lasil
shelves - (for books) = bukaboeds
shepherd - jipagaledan
shift (duty) - diur
(to) shine - litastralön, nidön
shingle - joad
ship - naf; nafön
shipwreck - nafön
    * to be shipwrecked = nafädön
shipyard - nafibumöp
shirt - jit, plöjit
    * shirt cuff = slivül
shock - jek
(to) shock - fäkükön, jeikön
shocking - jekälik, skänik
shoe - juk; jukön
shoe-lace - jukatanodül
shoemaker - jukel
(to) shoot - (execute) = deijutön (eki)
  - (gun) = jutön, jütön
shop - selidöp; nüremön
shop-assistant - selidöpan
shore - jol
short - brefik
    * to be short of cash = labön monadefi
    * short of breath = brefanatemamik
    * short-tempered = fäkädälik
shorthand - stenograf
shot-put - glöbijedam
shoulder - jot; jotön
(to) shout - luvokädön, lerorön
    * to shout for joy = vokädön fredo
shoulder - jot
shovel - jüpül; jüpülön, kolatajup (coal shovel)
(to) show (o.s.) - jonön (oki)
    * He didn't show up = no ädajonom oki
shower - (weather) = stomül, reinastomül
  - (bath) = dujet
    * to shower upon ... = stürön bundano sui ...
    * shower fitting = dujetaparat
shriek - leror
shrivelled - dafainik
shut - pefärmüköl; färmükön
    * to shut in = nüfärmükön
shutter - kläped (of window)
  - färmüköm (of camera)
shuttle (craft) - moegenaf
shy - plafik
sick - luvomitik, malädik
side - flan, sim
sideboard - blümükamatab, büfät, flanatab
(to) side with - stütön
siege = belesat
signal - malet
sigh - seif; seifön
sight - logam, logöfot (tourist)
sign - (written) = mal; malön
  - (emblem) = mäk
  - (hint) = vineg
    * to sign one's name = dispenön
signal - malet
signature - dispenäd
(to) signify - sinifön
sight (tourism) - logöfot
silence - (keep silent) = seil; seilön
    * to silence s.o. = seilükön eki
silent - seilik
silently - seiliko, seilölo
silhouette - silhuät
silk - sadin, sadinik
silken - sadinasofik
silly - fobik, klaunöfik, stupädik
(to be) silly - böfön
silver - largentin
    * table silver = largentastömem
similar - sümik
similarly - ön mod sümik
simple - balugik
sin - sinod; sinön (ta)
sinew - kordül
since - sis
sincere - stedälik
(to) sing - kanitön
singer - hi/jikanitan
single - balatik, seliban
singlet - niyäk
sink - (go under) = sadön, sädön
sinner - sinan
sinus - sinud
sir - söl
sister - jiblod, jigem, sör
    * a religious sister = jikleudan
(to) sit - seadön
sitting-room - sälun
(to be) situated - topön
    * to be situated on a river = topön len flumed
situation - plad, stad
size (shoe) - gretot
six - mäl
size - fomät,, gretot
skate - sket
(to) skate - sketön
skeleton - bomem
ski - skiy
skiing - skiyam
(to) ski - skiyön
skilful - skilik
(to) ski - skiodön
skill - kan, skil
skilled - jäfüdaskilik
skin - skin
skinny - mumägik
(to) skip - bunädön
skirt - juüp
skull - kran
sky - sil
    * skyscraper = silikratabumot
slander - slän; slänön
slate (school) - sletot
(to) slaughter - pugön
slave - hi/jislafan
slavery - slaf
sleep - slip; slipön
sleepy - slipöfik
sleeve - sliv
(to) slide - slifön
    * a sliding section = sleifakät
(to) slice - lenkötön
slight - pülik
slim - lunedik
sling - snal
slip - slifäd; slifädön
    * slip of the tongue = pök linega
slipper - pantuf
slope - kilv; klivön
slow - nevifik
sluice - klut
slug - laläf, vegasnel
slums - luslöm, slöm
sly - lukäfik
small - smalik
smart - klotugik
smear - smiv
(to) smear - smivön
smell - (odour) = smel
    * to smell of = smelön äs
    * to smell s.th. = smeilön bosi
smile - smilil; smililön (dö)
smoke - smok; smokön, smökön
smooth - smudik, smufik
(to) smooth - smufükön
snail - snel
snake - snek
    * snake-charmer = snekimagivülan
(to) snap - frakatön
(to) snatch - snapön
sneeringly - lukofiko
sneeze - snid; snidön
(to) sniff - bruvön
snore - snok, snor
(to) snore - snokön, snorön
snout - snud
snow - nif; nifön
    * snowdrift = nifakum
so - so
soap - sob
soapy - sobik
sob - slok; slokön
sober - dinöfälik
social - sogädik
    * a social circle = sogod
socialism - sogädim
socialist - sogädiman
socializing - sogalif
society - (general) = sog, sogäd
  - (organized society) = klub
  - (high society) = lesogäd
sock - (anklesock) = lustog
soft - (not hard) = molik
  - (gentle) = sofik
soil - glun; miotön
soldier - soldat
sole - (of foot) = futaplant
  - (seafood) = sölit
  - (of shoe) = sömäl
solemn - lezälik
solemnity - lezäl
solid - (not liquid) = solidik
solidarity - kobät
solution - soül, soülot
(to) solve - soulön, soülön, tuvedön (puzzle, etc)
some - (several) = anik
(to) somersault - daivülön
sometimes - ömna, semanaedo, semikna
somewhat - boso
son - hicil, son
son-in-law - lüson
song - kanit
soon - suno
    * as soon as = sosus
soothingly - takedükölo
sorry - (miserable) = lügik
  - (pitiable) = pöfädik
    * I'm very sorry = Pidob vemo
sort - bid, sot
soul - lan
sound - ton; toenön, tonön
    * to be sound = saunik
soup - sup
sour - züdöfik
source - fon, fonät
south - sulüd
southern - sulüdik
(to) sow - sovön
sower - sovan
space - spad
    * spacecraft / ship = kosmonaf, lespadanaf, levalanaf, sinaf
    * space-suit = siklotem
    * space helmet = sihät
    * space capsule = sikapsul
    * space age = lespada- / si(la)timäd
    * space station = sistajon
    * space probe = lespadabluf, sibluf
spacious - spadöfik
spade - jüp (= garden); pik (= card game)
spanner - skrubakik
spare - (left over) = retik
    * spare change (money) = mon retik
    * spare room = lotidacem
    * spare time = livüp
    * spare wheel = luib resärfik
(to) spare - (save) = spalön (eke bosi), spälön
spark - spag; spagön
(to) sparkle - spagülön
sparrow - spär
(to) speak - spikön
speaker - danunan (= radio/TV presenter); tonöm (= apparatus)
special - patik
(to) specialize (in) - patädodilön (oki)
specialized - jäfüdik
specific - patädik
spectacle - lüloged
spectacles - lünät
spectator - lülogan
speech - (power of) = spik
  - (discourse) = spikäd
  - (part of speech) = vödabid
speed - spid; vif; spidön, vifükumön
(to) spell - tonatön
spelling - tonatam
(to) spend - (time) = lifädön
  - (not save) = nespälön
  - (money) = segivön
sphinx - sfin
spider - raänid
(to) spin - spulön
    * spinning wheel = spulöm
spinach - spinad
spine - (anatomy) = bäkabom
spirit - (soul) = lan
  - (angel) = lanan
  - (ghost) = späk
  - (God) = lanal
(to) spit - spukön
spite - badöf, hetäd; hetädön, skänön
    * in spite of = to
spiteful - badöfik, hetädik
splendid - magifik
split - slitod; slitön
(to) splash about - megön
splashdown - sumelikam
spoil - berav; beravön
sponge - spog
spongy - spogöfik
spoon - spun
spoonful - spunet
sport - spot
sportsman - spotan
spot - (place) = plad
  - (mark) = sten
spotted - stenöfik
spray - gifülot
(to) spread out - = stäänikön, stäänükön
spring - (of water) = fonät
  - (to jump) = bunön, spranülön
  - (season) = florüp
sprinkled (over) - sustürülöl
sprinting - vifagol
(to) sprout - sprötön
squall - mistomül
(to) squander - fegebön
square - (shape) = follien, kvar
  - (geometrical) = kvad
  - (city / town) = piad
(to) squeeze out - sepedön
    * to tread grapes = besepön vitidabälis
squirrel - yat
stable - (for horse) = lecek
stadium - stadion
staff - (personnel) = pösodef
stage - (platform, trestle) = skaf
  - (theatrical stage) = städ
    * stage coach = potavab
stain - sten; stenön
stair - trid, tridem
staircase - tridem
    * spiral staircase = skrubädatridem
stairs - tridem
stalk - (of plant) = kaul, stäm
stalls (theatre) - partär
stamen (botany) - stamen
stamp - (postage) = flänükamamäk, penedamäk
  - (machine) = stäpedöm; stäpedön
(to) stand - stanön
standard - flag
staple (for office stapler) - nit
stapler (in office) - nitamacin, nitöm
star - stel
starling - sturnod
start - (of race) = derön; derönön
  - (departure) = detäv; detävön
  - (beginning) = prim; primön
starvation - fefaemam
(to) starve - fefaemön
state - (condition) = stad
  - (government) = tat
(to) state - nunön, stetön
stately - gravätik, in dekaklotem
statesman - tatan
station - (railway) = (ferodarutavega)stajon
  - (radio) = broadöp, radionastajon
stationer's (shop) - penömaselidöp
stationery - papüracans
statue - magot
    * an equestian statue = monitanamagot
stay - (sojourn) = steb; stebön
  - (delay) = zög; zögön
  - (reside) = lödön
(to) steal - tifön (eke bosi)
steam - stem; stemön
steel - stal
steep - skapik
(to) steer - stirikön
stem - kaul
step - step
    * steps (leading to entrance) = pärun
stepchild - hi/jilucil
stepparent - hi/jilupal
stern - (of ship) = pödanaf
  - (severe) = sevärik
stern (of ship) - pödastev
stick - staf
(to) stick - (stab) = steigön
  - (stick onto) = kleibön
sticky - (adhesive) = kleböfik
  - (viscous) = tönik, tönedik
stiff - stifik
(to) stiffen - stifükön
    * to become stiff = stifikön
stifling - teifülik
still - (yet) = nog
  - (quiet) = stilik
(to) stimulate - davedükön, stigädön
sting - stegül; stegülön
stink - lusmel; lusmelön (äs)
stipulation - stip
(to) stir - mufilön
stirring - (all go) = jäfik
stitch - näg
(to) stitch - nägön
Stock Exchange - Leböb
stocking - stog
stomach - stomäg
stone - ston
stop - (bar, barrier) = stöb; stöbön
  - (holding up) = stöpäd; stöpädön
  - (bus, train) = stopöp
  - (cause to stop) = stöpön
    * The bus stops here = Nibud stopon is
store - (department) = canöp
  - (warehouse) = magad; magadön
  - (shop) = selidöp
    * to store (goods) = leseitöm (canis)
storehouse - caniselidöp
storey - (floor) = tead
stork - stork
storm - tep
story - (tale) = konot
stove - furnod
straight - stedälik
strain - töbid; töbidön
straits - (sea) = melarovöp
strange - bisarik
stranger - foginan
strap (shoe) - küired
straw - stol
strawberry - frag
(to) stray - deikön
stream - bluk, flum, leflumed; flumön
street - süt
    * High Street = lesüt
(to) stretch - tenädön, tenikön, tenükön
  - (stretch out) = koltenükön
strict - sevärik
strike - (workers') = atraik; straikön
    * He struck (his) brother = äflapom blodi
    * It is striking ten = tonons düps deg
    * On the stroke of ten = ebo tü düp 10id
string - lefad
  - (for packing purposes) = tanamajain
strip - taned
(to) stroke - röbülön
strong - nämik
struggle - komip, töbid;
  - komipön (ta), letöbidön (ta)
stub - retäd
student - studan
study - stud; studön
stuff - (thing) = din
  - (material) = mater
  - (substance) = stöf
  - (turkey) = steigädön
stuffy - (stifling) = teifülik
stumbling - tifalöl
stupid - stupik
stupidity - stup
(to) stutter - stötön
style - maget
stylist - (fashion) = vogädan
subject - (person) = reigäb
  - (grammar) = subyet
submarine - daivanaf, dismelanaf
submission - sumätükam
(to) submit - (yield) = sumätükön
substance - (essence) = stöf
  - (reality) = jenöf
  - (theme) = ledin
substantial - jenöfik, ledinik, stöfik
(to) subtract - (maths) = näedön
suburb - fozif
(to) succeed - (continue) = fovön
  - (prosper) = plöpön
  - (follow on) = sökön
success - benosek, benosuf
succession - gerafov
successive - sökaleodik
successively - sökaleodiko
successor - (person) = fovan
succulent - vaetöfik
such - somik
    * such and such a one (= person) = soman
(to) suck - sugön, sügön
such - somik
sudden - süpik
suddenly - süpo
(to) suffer - liedön (demü), sufön
(to) suffice - saidön
suffocation - teaf
sugar - jueg
suggestion - mob, tikodükam
suicide - oksasen
suit - (of clothes) = klotem
(to) suit - klotugön, lönedön, pötön
suitable - (appropriate) = lönedik, pötik
(to be) suitable (for) - lönedön (pö)
sum - (total amount) = kobonum
summary - (résumé) = naböfodönuam
summer - hitüp
summit - sömit
sun - sol
(to) sunbathe - solön (oki)
Sunday - sudel
sunken rock - klip
sunrise - solasülöpikam, sülöpikam sola
sunset - solamodonikam, modonikam sola, solamoikam
sunny - solöfik
superhuman - susmenik
superior - löpik
superiority - löp, veüt
supermarket - lemaket
supersticion - lukred
supper - säned
supplementary - läfulükik
(to) supply - blünön
    * supply and demand = mand e lof
    * to supply s.th. missing = läfulükön
support - stüt
(to) support - stütön
supporter - stütan
(to) (pre)suppose - büocedön
supreme - levemik
    * The Supreme (Being) = Dabinal
sure - fümik
    * Sure! = fümö! lesi!
surface - platot, sürfat
surgeon - kötetavan
surname - famülanem
surprise - benosüpot, süpäd; süpädön
surrender - klemed; klemedön
(to) surround - züön
surroundings - züamöp
(to) suspect - badiniludön (tefü ek)
suspicion - badinilud, minilud
suspicious - badiniludik, miniludik
swallow - (bird) = sval
(to) swallow - slugön
(to be) swarming (with) - grulön (dub)
(to) sway - kledön
(to) swear - (curse) = blasfämön
  - (take oath) = yulön
sweat - suet; suetön
(to) sweep - kluinön, svipön
sweet - svidik
(to) swell - svelikön
    * a sea swell = hul
swift - spidik, vifik
swim - svim; svimön
swindle - lecüt; lecütön
swing - (for children) = pendülöm
(to) swing - pendülön
(to) swirl - virilön
switch - (light) = litakurbidöm
  - (electric) = lektinaflumikurb
  - (general) = kurb
(to) switch on/off - nikurbön/sekurbön
sword - gläv
syllogism - blöfed
sympathetic - keliedik, kesenälik
(to) sympathize - keliedön (ko), kesenälön
sympathy - (feeling for) = kelied
  - (compassion) = baisenäl, kesenäl
symptom - sümptom
syrup - sirup
system - sit
systematic(al) - sitik

-------------------- T--------------------

table - tab
    * a narrow, decorative table cover = tabaletaned
    * table silver = largentastömem
    * a table cloth = tabastofed
tablecloth - tabastofed
tablespoon - fidaspoon
tablet - diled (= of soap); pilul (= medication)
tail - göb
    * a tailcoat = trelülagun
tailor - skrädan
(to) take - sumön
(to) take away - mosumön
(to) take off (clothes) - deükön
tale - konot
talk - spikod; spikodön
    * to prattle = luspikön
talkative - spikotälik
tall - gretik
tambourine - tamburen
tame - teamik; teamön
tangent (maths) - tangänt
tangle - brul
tank - bänsinacub (= petrol tank); bländ (= military)
tap - (gas, water) = ronät
  - (hit lightly) = flapil; flapilön
tape - (video) = magodatanil
  - (audio) = tonatanil
tape recorder - tonodiregistaröm
tar - tar
tariff - tarif
(to) tarnish - säkölikön
task - bligäd, vobod
taste - gut; gutön
    * to taste of = smekön (äs)
tastefully - gütiko
(to) tattoo - tätuvön
tax - trip; tripön
taxi-cab - loatatood
tea - tied
(to) teach - tidön
teacher - tidan
team - kvip
teapot - tiedaskal
tear - (from eyes) = dren
  - (slit) = sleit; sleitön
teaspoon - tiedaspun
technical - kaenik
(to be) teeming (with) - grulön (dub)
teeth - tutem, tuts
telegram - telegrafot, depad
telegraph - telegraföm; telegrafön
telegraphist - telegrafan
telegraphy - telegraf
telephone - telefonöm; telefonön
telephonist - telefonan
telephony - telefon
television - televid
    * TV channel = televidadaäd
    * TV series = televidasökod
(to) tell - (relate) = konön
  - (say) = sagön
temper - vim; tämükön (metals)
temperament - natäl
temperature - vamot
  - (to have a temperature) = fifön
temporary - nelaidik, nelaidüpik
temple - (anatomy) = tämep
  - (religious) = tem
(to) tempt - blufodön
temptation - blufod
tempting - blufodik, lübätik
ten - deg
tendency - klien
tender - molädik, müdik
tender-hearted - zadälik
tenderly - molädiko, flenöfiko
tendril - tedril
tennis - tänit
tenor (music) - tenor
tension - tenid
tent - tänad
tepid - vamülik
term - (expression) = notod; notodön
  - (date for paying) = pelüp
  - (time) = tüp
terms (of business) - nüns
terrace - tärat
terrible - jeikik
test - bluf; blufön
testicle - tästig
text - vödem
textbook - tidabuk
than - ka
thank - dan; danön
thankful - danöfik
that - (conjunction) = das, dat
  - (demonst. pronoun) = et, etos
  - (relative pronoun) = kel
the - el, hiel, jiel
theatre - teat, teatöp
theft - tif, tifot
then - täno
    * from then on = siso
theorem - leset
theory - teor
there - us
    * there is/are = dabinon(s)
thereby - dubo
they - oms, ofs, ons
thick - bigik
thief - tifan
thieves - tifans
thievish - tifiälik
thigh - (anatomy) = küid
thin - slenik
thine - orik
thing - din
(to) think (about) - tikön (dö)
  - (to ponder) = meditön, ninälön, süenikön
  - (to think out) = datikön
third (music) - kiltonod
thirst - soaf; soafön
thirsty - soafik
this - at, atos
thorough - staböfik
thou - or
though - do
thought - tik, tikod
thousand - mil
thread - fad
(to) threaten - tädön
threatening - tädik
three - kil
throat - gug, slug
throne - tron
through - da
(to) throw - jedön; stürön (onto a pile)
thrush - turd
thumb - döm
thunder - tonär; tonärön
thunderstorm - mistom
Thursday - dödel
thus - kludo, so
thy - orik
thymus (gland) - tüim
thyroid (gland) - türeoid
thyself - or it
(to) tick (sound of clock) - tikitön
ticket - biliet, tävakad
    * single ticket = biliet moik
    * return ticket = biliet geik
(to) tickle - jätülön
tide - taid
    * ebb and flow = bän e flud
tie - (necktie) = kravat
tiger - tigrid
tight - (tightfitting) = nabalenik
  - (tense) = tenidik
(to) tighten (up) - tenidükön (plu)
tile - tvil
till - jü
time - naed, tim
    * what time is it? = düp kinik binos-li?
    * sometime (or other) = seimikna
    * for the time being = büfo
    * each time = alna
timer - timimafian
timetable - (buses, trains) = vegamataib
tin - (metal) = stanin
  - (sheet) = tün
tingling - stigül
tin-opener - bügimaifüköm
tint - kölül
tiny - vemo smalik
tip - (gratuity) = drinamon; givön drinamoni
  - (point) = tipot
  - (cigarette) = mudot
(to) tire - fenikön, fenükön
tired - fenik
title - (of book) = tiäd
  - (honour) = titul
to - ad, jü, lü
toad - bufod, rosip
toaster - bodifilädöm
tobacco - tabak
tobacconist - tabakiselan
(to) toboggan - slifavabön
today - adel, adelo
toe - tean
together - kobo
    * together with = sa
(to) tolerate - sufälön
tomato - podor, tomat
tomorrow - odel, odelo
tone - tonod, vögäd (= of voice)
tongs (pair of) - filazäp
tongue - (in mouth) = lineg
  - (language) = pük
tonight - aneit, aneito, asoar, asoaro
too - (also) = i
  - (to excess) = tu
tool - stum
torch - pokalampad
tooth - tut
toothache - tutadol
toothbrush - tutikef
toothpaste - tutakrem
top - (toy) = tupit
  - (summit) = sömit
topmost - go löpo
torpedo - melaraket
tortoise - tortug
(to) torture - tomön
total - kobonum
totally - valodiko
touch - (sene of) = kontag; kontagön
    * to touch with finger(s) = doatön
tough - (stringy, viscous) = tönik
tour - zugot
toward(s) - lü
towel - taul
tower - tüm
town - zif
town hall - konsälöp
toy - pledadin
toyshop - pledadinaselidöp, selidöp pledadinas
trace - rut
(to) trace - (canal, road) = disinotön
track - rut
tractor - traktor
trade - ted
(to) trade - tedön
traffic - dakosäd
    * a traffic refuge = sütasefädöp
train - tren
(to) train - (sports) = drätodön (oki)
training - drätod
tram - träm
transaction - tedot
transept (of church) - traväröp (glüga)
(to) transfer (to) - lovepladön (lü)
transformer (of electric current) - feafomöm (fluma lektinik)
(to) translate - tradutön
translation - tradut, tradutod
translator - tradutan
transmission - trab
transmutation - dacein
transparent - dulogamovik
transport - veig; veigön
travel - täv; tävön
tray - bötöm, lebavet
treasure - div
treasurer - diviguvanef
(to) treat - (talk about) = bespikön
  - (deal with) = träitön
treatment - (medical) = lekäl
  - (general) = träit
treaty - baläd
tree - bim
    * tree trunk = stamod
trellis-work - treil
(to) tremble - dremön (dub, sekü)
trespass - miveg
trial - (law) = cödäd
(to bring to) trial - cödädön
triangle - killien
trick - käfed; cütön
(to) trickle - mürön
trifling - nensüenik
trigonometry - trigonomet
trip - (excursion) = lespat
(to) trip - tifalön
(to) trip off - lespatön
(to) trip (someone) up - tifalükön
trolley-bus - lektinanibud
troop - trup
troops - trupe, trups
tropics - vütroplän
trouble - (worry) = kud; kudön
  - (effort) = töbid; töbidön
  - (upset) = töb; töbön
trousers - (pair of) = blit
trout - trüit
truck - fledatood, fledavab
true - veratik
trunk - (elephant) = probod
  - (luggage) = trök
  - (of tree) = stam
trunks (swimming) - svimablitil
trust - konfid; konfidön
truth - verat, veratod
(to) try - steifülön
  - (to try on clothes) = mafidön
tuba - tubat
tube - rüdet, skrün (= TV set)
Tuesday - tudel
tug - (boat) = tränanaf
(to) tug - tirülön, tränön
tulip - tulip
tundra - muskän
tune - lid, melod
  - (to tune to) = baitonükön (= radio, TV, etc)
  - (to tune in) = proädön = radio, TV, etc.)
tunny - (fish) = toün
turkey - (bird) = dindun
turn - (mechanical) = tul; tulön, tülön
    * p.t.o. (= please turn over) = B.g.b. (= Begö! güflekolös bledi)
    * to turn to a friend = flekön lü flen
    * to turn over = güükön
    * to turn (into) = loveivotön (ini)
turnip - navät
turpentine - tereben
turquoise - türkot
twelve - degtel
twin - hi/jitelädan
(to) twist - (fibres) = fadotelön
  - (around) = zütülön
two - tel
type - (category) = pated
(to) type - (on keyboard) = klavön
tyre - niluibarif, rif
typewriter - penamacin
typical - patedik
typist - klavan

-------------------- U--------------------

ugly - nejönik
ukelele - kuelel
umbrella - reinajelöm
unaccustomed - nekösömik
unacquainted - nesevädik
unalterable - neceinovik
unaltered - no pevotüköl
unambiguous - netelplänovik
unambitious - nestimiälik
unapproachable - nelügolovik
unassisted - nen yuf
unattractive - nekeinotik
unavailable - negebidik
unavailing - vanik
unavoidable - nevitovik
unaware - nensevedik
unbalanced - no leigavetik
(to) unburden - säfledön
uncanny - dredilik
unchecked - no peneletöl
uncivilized - nekulivik
unclaimed - no peflagöl
uncle - hiter, ziom
unconfirmed - no pezepöl
unconquerable - nevikodovik
unconscious - nesevälöfik
uncontrolled - no peneletöl
(to) uncover - sävilupön
undeniable - nenoamovik
under - dis
(to) underline - dislienükön
(to) undermine - fibükön
underpants - niblit
(to) underrate - läsdigidön
(to) understand - suemön, lelilön
undertaker - funisepülan
undeserved - nemeritik
undeservedly - nemeritiko
undesirable - nedesirabik
undeveloped - nendaglofik
(to) undress (o.s.) - säklotön (oki)
undue - no nog pelabik
uneasy - (on edge) = muifükik
uneducated - midugälik
unemployed - nenvobik
unemployment - nenvob
unequal - neleigik
unequalled - neleigodovik
uneven - negidik
unexplored - no pebeletävöl
unfaithful - nefiedik
unfamiliar - nekösömik
(to) unfasten - livükön
(to) unfold - maifükön
unfortunate - liedik
unfortunately! - liedö!
unfurnished - no pemöböl
ungraceful - nekeinik
ungracious - neplitik
ungrateful - nendanik, nedanöfik
unguarded - no pegaledöl
unhappy - neläbik
unharmed - nenviodik
unhesitating - nenzogik
unhesitatingly - nenzogiko
unholy - nesaludik
uniform - leiged
uniformity - leigafom
unimpaired - nätik
unimproved - no pemenodöl
uninhabited - no pebelödöl
uninjured - nendämik
uninterestedly - nenitedäliko
uninterrupted - nenropik
union - (unity) = balam
  - (union) = balatam
  - (federation) = fed
unit - balat
(to) unite - balön
united - pebalöl
unity - balat
universal - valemik
university - niver
unjust - (unfair) = negidik
  - (in law) = negitik
unknown - nesevädik
unless - (provided that) = bisä
unlimited - no pestöböl
(to) unload - säfledön
(to) unlock - mailökön
unmerited - no pemeritöl
unmistakeable - nemisevabik
unobserved - no peküpöl
unoccupied - no pebeseidöl, no pekoupöl
unofficial - necalöfik
(to) unpack - säpäkön
unpolished - no pesmufetöl
unpopular - nepöpedik
unprofitable - nefrutik
unprotected - nenjelik
unreliable - nekonfidovik
unripe - nemadik
unscientific - nenolavik
(to) unscrew - livioskrubön, seskrubön
unsettled - (metally) = kofudik, pekofudüköl
unshaven - no pejeiföl
unskilled - neskilik
unsound - nesaunik
unstained - nenmiotik
unsteady - mufülik, nefümik
unsuspected - neminiludik
unsympathetic - nesitik
untrained - no pedrätodöl
unwearied - nenfenik
unwitnessed - no fa timanans pelesiöl
(to) unwrap - sävilupülön
unyielding - fümädik
up - löpio, löpo
upon - su, sui
(to) upset - (emotionally) = brulükön
  - (knock over) = dojoikön
  - (confuse) = kofudükön
  - (emotionally) = favik
(to) urge - dranön
urgency - dranöf
urgent - dranöfik
(to) urinate - yurinön
use - frut, geb; frutön, gebön
useful - frutik
useless - nefrutik
usual - kösömik
    * to be usual = kösömön
utter - mu lölöfik
utterly - mu lölöfiko

-------------------- V--------------------

vacation - vaken
(to) vaccinate - müpön
vaccination - müp
vacuum cleaner - püfisugian
vague - lufümik
vain - (of people) = lupleidik
  - (empty) = vanik
  - (unsuccessful) = nensekik
vainly - nensekiko, vaniko
valid - lonöfik
valley - fälid
valuable - völadik
value - völad
(to) value - völadön
valve - väntil (= ventilator); pir (= radio)
van - fledatood
vanilla - vanel
    * a vanilla ice-cream = vanelagladet
vanity - van
various - distöfik
vase - vasod
vast - gianagretik, levemik
veal - bubülamit
vegetable - härbat
vegetation - planaglof, planem
vehicle - vab, veigöm
vein - (anatomy) = vein
venerable - bäldagravik
vengeance - vindit
venture - riskod; riskön
verdict - cödispiked
vermin - minimilem
verse - (poetic) = setül
very - veratik, voik, vemo, go
    * it's a very paradiese = at binon parad voik!
vessel - (blood vessel) = fesül
  - (in general) = gef
  - (boat, ship) = naföm
vest - nijit
(to) vibrate - branön, dremön
vibration - dremet
victor - vikodan
victorious - vikodik
video (recorder) - magodasumodöm
victory - vikod
view - selogam
    * point of view = leced
viking - viken
village - vilag
vinegar - vinig
vineyard - vitidagad
violence - näpet
violent - mäpetik
viral - virudik
virtue - tug
virtuous - tugik
virus - virud
visible - logädik
    * (to become) visible = logädikön
visit - visit; visitön
vitamin - vitamin
voice - vög
volume (sound) - ton
    * a volume control = toninämükian
vomit - sput, vomitot; sputön, vomitön
vote - vögod; vögodön
voter - vögodan
voyage - melatäv, täv
vulgar - komunik
vulture - vultur
    * a bearded vulture = jipülavultur

-------------------- W--------------------

wadding (cotton filling) - vod
(to) waddle - mufülön
wage - mesed
waist - zekoap
waistcoat - jilät
(to) wait - stebedön
waiter - bötan
    * head waiter = lebötan
waiting room - stebedalecem
(to) wake - (to watch) = galön
  - (to wake up) = galikön
  - (to waken s.o.) = galükön
Wales - Velsän
walk - spatam
(to) walk - golön, spatön
    * a walk-about = zivabam
wall - (outside) = mön
  - (inside) = völ
wallflower - matiol
(to) wander - ziglibön, zigolön
wanderer - zigliban, zigolan
want - (lack of) = def; defön
  - (without) = nelab; nelabön
  - (to need) = neod; neodön
  - (will) = vil; vilön
war - krig; krigön
warehouse - canamagad
(to) warn - nunedön
warning - nuned
warm - vamik; vamikön, vamükön
(to) warn - nunedön
warning (= sign) - nunedapenäd
wash - lav; lavön
wash-basin - lavaböväd
washer - (appliance) = lavacin
wasp - vesep
waste - (desert) = natädöp, soalöföp
  - (to squander) = nespäl; nespälön
watch - (vigilant) = gal, galäd, galed; galön, galädön, galedön
    * pocket watch = pokaglok
watchman - galedan
watch-chain - pokaglokajän
watchmaker - glokel
water - vat
    * a water lily = nümfead
(to) water - vatön
waterfall - vatafal
watery - vatöfik
wave - (of sea) = vef; vefön
  - (greetings) = vineg; vinegön
  - (to wave hair) = vefafomön
  - (something in hand) = lefänön
wavelength - vefalunot
way - (path) = veg, vegil
  - (method) = mod
WC - (water-closet) = prifet, tvalet
we - obs
weak - fibik
wealth - lieg
wealthy - liegik
weapon - vaf
(to) wear (clothes) - lenlabön (klotis)
    * to wear out = vorikön
weariness - tufav
wearisome - tufavüköl
weary - tufavik; favikön, favön
weather - stom
    * weather forecast = stomanunod
weave - vivot; vivön
web - spuled
    * a web site (computer) = resodatoped
(to) wed - matikön (ko)
wedding - mated, matikamazäl
Wednesday - vedel
week - vig
(to) weep - drenön
(to) weigh - (mentally) = vätälön
  - (general) = vätön, vetön
  - (specific) = vetotön
weighbridge - baskül
weight - vätäl, vät, vetot
well - (quality) = gudiko, saunik
  - (well of water) = fonäd
west - vesüd, vesüdik
wet - luimik; luimükön
  - ( to get wet) = luimikön
whale - valüt
wharf - melakäv
what - kio, lio
    * what sort of ... ? = kisotik
whatever - kiosotik, alseimik
wheat - vuit
wheel - luib
    * a spinning wheel = spulöm
wheelchair - rölastul
wheezy - neumatik
when - (interrogative) = kitimo?
  - (relat. pronoun) = kü
  - (conjunction) = ven
where - (relat. pronouns) = in kel(s), dü kel(s), kö
  - (interrogative) = kiöpö? kiplado? kitopo?
whether - va
which - (relative pronouns) = kel, hikel, jikel, kelos
  - (adjectival interrogative pronouns) = kinik? kimik? kifik? kisik?
while - du
whip - bat; batön
    * to play at whip and top = tupitön
(to) whisper - spikön nelaodiko
whistle - flutül; flutülön, feifön
white - vietik
who - (interrogative pronouns) = kim? kif? kin? kis?
  - (relative pronouns) = kel, hikel, jikel, kelos
whole - lölik
why - (interrogative) = kikodo?
    * for which reason = kodä (sekü kod kelik)
wicked - lesinik
wickerwork - flök
    * a wickerwork chair = flökastul
wide - (spread out) = veitik
  - (broad) = vidik
    * wide-seemed = vidasimik
widow - jiviudan; viudikön
widower - hiviudan
width - vidot
wife - jimatan
wild - (in the raw) = natädik
  - (undomesticated) = sovadik
will - vil; vilön
salig
    * weeping willow = vatasalig
(to) win - gaenön
wind - vien
    * it's windy = vienos
(to) wind - ginädön
    * to wind a watch = ginädön gloki
    * to wind in a coil = krugikön
windmill - vienamül
window - fenät
windward (nautical) - luf
windscreen - tavienvitür
wine - vin
wineglass - vinavär
wing - flitäm
    * a (house) wing = flanäd
winter - nifüp
(to) wipe - dekluinön
wire - drat
wireless - radion
wiry - dratik
wise - sapik
wish - vip; vipön
witness - temunan; temunön
with - ko, me, medü
withered - fainik
without - nen
wolf - lup
woman - jimen, vom
wonder - stun, stunidot; stunön
    * I wonder whether ... = nulälob va ...
(to) be wont to - kösömön ad
wood - (substance) = boad
  - (grove) = fot
woodpecker - pikit
wool - lain
woollen - lainik
word - vöd
work - (achievement) = duinod
  - (exertion) = vob; vobön
working capital - febakatäd
workman - hivoban
world - vol
worm - vum
worn out - voredik
worry - tom; tomön
worse - badikum, badikumo
worship - kult, leplekam; kultön, leplekön
worshipper - kultan, leplekan
worsted (cloth) - köbamayän
worth - (persons) = digädik
  - (things) = völad
  - (general) = digik
(to be) worth - völadön
wound - vun; vunön
(to) wrap - vilupön
wrapping-paper - päkamapapür
wreck - (shipwreck) = nafäd, nafädot; nafädükön
wreckage - nafädot
(to) be (ship)wrecked - nafädön
wrench - letiröm
wretch - (person) = miseraban, pöfilan
wretched - miserabik
wrinkle - fron
(to) wrinkle - fronükön
wrist - riet, rietayoin
wristwatch - rietalinaglok
(to) write - (literature) = lautön
  - (letters) = penön
wrong - dobik, neverätik

-------------------- X--------------------

xenophobia - foginananeflenäl
Xmas - Kritidazäl
x-ray - räyastrals, Röntgen-stralam
xylographic - boadabükik
xylography - boadiködav
xylophone - xülofon

-------------------- Y--------------------

yacht - yakt
yard - yad
(to) yawn - cavön
year - yel
yearly - alyelik
yellow - yelovik
Yes! - Si!
yesterday - ädel, ädelo
yet - (still) = nog
  - (despite) = toä
  - (however) = too
yew - taxud
(to) yield - klemedön (lo), yilidön (lo)
yogurt - yogurt
you - ol, ols
young - yunik
your - ol/ols, olik/oliks, ola/olas
youth - (general) = yun
  - (person) = yunan
  - (group) = yunanef
  - (adolescence) = yunüp
youthful - yunöfik

-------------------- Z--------------------

zeal - lezil
zebra-crossing - sütilovegolöp stripik
zen - zenim
zero - ser
zig-zag - zikzakik
zither - ziter
zoo - nimagad 
